-	\nenter\nv.\n～に入り込む | enter ~\nCentral
0	[neru/o]\nadjective\n0\n0\nCentral Standard Note
1	[noi/i]\nadjective\n1\n1\nCentral Standard Note
10	[deku/de]\nadjective\n10\n10\nCentral Standard Note
100	[heku/he^]\nadjective\n100\n100\nCentral Standard Note
1000	[kiku/kii]\nadjective\n1000\n1000\nCentral Standard Note
10000	[miku/mii]\nadjective\n10000\n10000\nCentral Standard Note
2	[ji]\nadjective\n2\n2\nCentral Standard Note
3	[dori]\nadjective\n3\n3\nCentral Standard Note
4	[fefu]\nadjective\n4\n4\nCentral Standard Note
5	[vira]\nadjective\n5\n5\nCentral Standard Note
6	[ikusa]\nadjective\n6\n6\nCentral Standard Note
7	[heputo]\nadjective\n7\n7\nCentral Standard Note
8	[okuta]\nadjective\n8\n8\nCentral Standard Note
9	[nei]\nadjective\n9\n9\nCentral Standard Note
<-x	[(su)pagu]\nlanguage construct\nこれ \n(anaphor indicator) \nNew Testament of Pastalie
>>	\nlanguage construct\nTras\nTras\nCentral
ADDR	[?]\nlanguage construct\nアドレス指定 \naddress designation \nUnknown [Unofficial]
Chronicle Key	\nn.\nヒュムノス・クロニクルキー\nChronicle Key (a hymn)\nAlpha (Eolia)
D_CELL	[D serofan]\nlanguage construct\nDセロファン \nD-Cellophane \nUnknown [Unofficial]
Despedia	\nn.\nヒュムノス・デスペディア\nDespedia (a hymn)\n
Dia	[dia]\nn.\n王、王座、玉座、支配者\nking, throne, ruler\nCentral Standard Note
EXA_PICO	[ekusapi^ko]\nnoun\nエクサピーコ \nExa Pico \nUnknown [Unofficial]
Fou	[fou]\nE.s. I\nちょっと\nA little\nCentral Standard Note
Haibanation	[haiba^neshon]\nn.\nヒュムノス・ハイバーネション\nHibernation (a hymn)\nUnknown [Unofficial]
Harmonius	\nn.\nヒュムノス・ハーモニウス\nHarmonious (a hymn)\nCentral
Implanta	[imupuranta]\nn.\nヒュムノスイムプランタ, 神の大樹, 実\nImplanta (a hymn); God's Tree in the myths of Metafalss, fruit, seed\nUnknown [Unofficial]
Linca	[rinka]\nn.\nヒュムノス・リンカ\nLinker (a hymn)\nCentral Standard Note
Ma	[ma]\nE.s. I\n平常心\npresence of mind\nCentral Standard Note
Manac	[manaku]\nn.\n真名、魂の名前、御魂名\ntrue name, name of soul\nCult Ciel Note
Maoh	\nn.\nマオ\nRhaplanca's partner in the myths of Metafalss.\nAncient Metafalss
Meta	[?]\nnoun\n? \nMid-sized mountainous region \nUnknown [Unofficial]
Metafalica	[metafarika]\nn.\nヒュムノス・メタファリカ\nMetafalica (a hymn), Song of Hope (to Mir), Song of Creation, Utopia\nMetafalss Note
Nn	[n]\nE.s. I\n無気力状態\nlethargy\nCentral Standard Note
Paja	[pa^ja]\nn.\nヒュムノス・パージャ\nPurger (a hymn)\nCentral Standard Note
Phantasmagoria	[fantasumagoria]\nn.\nヒュムノス・ファンタスマゴリア\nPhantasmagoria (a hymn)\nAlpha Note (EOLIA)
Re=Nation	[rineishon]\nn.\nヒュムノス・リネイション\nRe-Nation (a hymn)\nCentral Standard Note
Replekia	\nn.\nヒュムノス・レプレキア\nReplakia (a hymn)\n
Rhaplanca	\nn.\nラプランカ\na goddess from Meta Falss' mythology, and Maoh's partner\nAncient Metafalss
Rig=Veda	[riguve^da]\nn.\nヒュムノス・リグヴェーダ\nRigveda (a hymn)\nMetafalss Note
Rrha	[ra]\nE.s. I\nトランス状態 (自分の気が正気か否かもわからないくらいトランス状態の時に使う。もっとも、これを使うときは、これ以外の想音を使おうと思えるほど冷静ではないので、自然とこれが口から出てくる。)\ntrance state (Note: Used only for a trance state in which the emotions of the singer aren't really expressed. Naturally, when this emotion sound is used, it doesn't show the same calm and composure of the other emotion sounds, and it flows by itself from the mouth of the singer)\nCentral Standard Note
Sol=Fage	\nn.\nヒュムノス・ソルフェージ\nSolfege (a hymn)\n
Sphilia	\nn.\nヒュムノス・スフィリャ\nSphilia (a hymn)\n
Sublimation	\nn.\nヒュムノス・サブリメーション\nSublimation (a hymn), sublimation (as in disappear)\n
Suspend	[sasupendo]\nn.\nヒュムノス・サスペンド\nSuspend (a hymn)\nCentral Standard Note
U-TA	[?]\nnoun\n「詩」 \nsong \nUnknown [Unofficial]
VIENA	\nn.\nヒュムノスヴィーナ\nViena (a hymn)\n
Was	[wasu]\nE.S.I\nとても強烈に（第Ⅰ想音）\nvery intensely\nCentral Standard Note
Wee	[ui]\nE.S.I\nかなり（第Ⅰ想音）\nfairly\nCentral Standard Note
a.u.k.	[auku]\nE.v.\nbe動詞に相当\nbe\nNew Testament of Pastalie
accrroad	[akuro^do]\nv.\nあげる 与える\ngive, send\nCentral Standard Note
acra	[akura]\nadv.\nきっと、確かに (高い可能性を示す語句)\nsurely, certainly (Note: Used for expressing something that's highly probable to happen)\nCentral Standard Note
adyya	[adei^a]\nn.\n今日・本日\ntoday\nCentral Standard Note
afezeria	[afezeria]\nv.\n祝福する\nbless\nCentral Standard Note
ag	[agu]\nconj.\nそして、～と (and)\nand (Note: Equivalent to the English ""and"")\nNew Testament of Pastalie
aiph	[aifu]\nconj.\nもし～ならば\nif\nCentral Standard Note
aje	[ajie]\nadj.\n新しい\nnew\nNew Testament of Pastalie
akata	[akata]\nn.\n物語\nstory\nCentral Standard Note
ale	[a^re]\nn.\n音\nsound\nNew Testament of Pastalie
alroen	[?]\nn.\n証\nProof, testimony\nUnknown [Unofficial]
alroetsue	[auroettoyu^e]\nadj.\n贖いの、償いの\nof atonement, of recompense\nMetafalss Note
ammue	[amyu]\nn.\n音、（音の）波動\nsound, sound waves\nCult Ciel Note
amyure	[?]\nnoun\n懺悔 \nrepentance, penitence \nUnknown [Unofficial]
an	[an]\nadv.\n～と共に\ntogether\nCentral Standard Note
anw	[anwa , anu]\nprep.\n～を (後ろに来るアルファベットが子音か母音か等、状況によって、最後の発音が変化します。 後ろの単語とつなげて発音した時、より音がきれいに流れる発音を選択してください。)\n(direct object marker) (Note: The pronunciation changes depending on if the last letter of the preceeding word was a vowel or consonant. The pronunciation used (""anwa"" or ""anu"") depends on which one the speaker thinks that flows and sounds better with the rest of the phrase)\nMetafalss Note
apea	[apea]\nE.s. (II)\n幸せでぽわー\nimmersed in happiness\nCult Ciel Note
ar	[aru]\nadj.\n唯一つの\nonly, unique\nCentral Standard Note
araus	[?]\nv./n.\n取替\nexchange\nUnknown [Unofficial]
arhou	[a^fu^]\nn.\n希望, 恩恵\nhope, wish, blessing\nNew Testament of Pastalie
arrya	[arya]\nn.\n矢\narrow\nCentral Standard Note
arsye	[a^shie]\nv.\n分け合う\nshare\nCentral Standard Note
art	[aruto]\nconj.\n～によって\nbecause of, by means of\nCentral Standard Note
asyar	[?]\nverb\n溶く \nmelt into \nUnknown [Unofficial]
aterra	[?]\nv./n.\n受け入れる\naccept, receive\nUnknown [Unofficial]
ates	[?]\nv.\n受け入れる\naccept, receive\nUnknown [Unofficial]
au	[au]\nE.s. (II)\n悲しい\nsad\nAlpha Note (EOLIA)
aulla	[aura]\nv.\n開く、開放する、開示する、明かす\nopen, disclose, reveal\nCentral Standard Note
ayulsa	[ayurusa]\nn.\n永遠, 永遠に、ずっと続く\neternity, for the eternity, continues forever\nNew Testament of Pastalie
balduo	[barudou^]\nadj.\n暗い、暗黒の、見えない, 闇\ndark, of darkness, unable to be seen\nNew Testament of Pastalie
bale	[bare]\nn.\n玉\nball, jewel\nCentral Standard Note
bansh	[banshu]\nv.\n（荒々しく扉などを）開く\n(violently) open (a door etc.)\nCentral Standard Note
basilic	[bajiriku]\nn.\n大砲 (大蛇。(転じて)大砲)\nbig snake, (derivative meanings) gun, cannon\nCentral Standard Note
bautifal	[bateifaru]\nadj.\n美しい、綺麗な\nbeautiful\nCentral Standard Note
beja	[beja]\nv.\n汚す\ndirty, defile\nCult Ciel Note
beng	[bengu]\nconj.\n以前 （時間的に）前\nbefore (time), ago\nCentral Standard Note
bengnuih	[benui]\nn.\n夕刻 夕方 黄昏れ\nevening, dusk\nCentral Standard Note
bexm	[bezumu]\nv.\n（時間が）来る、訪れる\ncome (time)\nCentral Standard Note
biron	[biron]\nv.\n続く\ncontinue\nCentral Standard Note
bister	[bisuteru]\nn.\n獣 野獣\nbeast\nCentral Standard Note
boches	[bochiesu]\nn.\n口\nmouth\nCentral Standard Note
boh	[boffu]\nadj.\n爆発的な、超常的な\nexplosive, supernatural\nMetafalss Note
brinch	[burinku]\nn.\n枝\nbranch\nCentral Standard Note
briyante	[buriiyante]\nn.\n歓喜の声、喜びの声\nvoices of delight, voices of joy\nMetafalss Note
briyua	[?]\nadjective\n喜びの \nhappy, joyful \nUnknown [Unofficial]
burle	[buure]\nadj./n.\n青 青い 蒼\nblue\nCentral Standard Note
byui	[?]\nconj.\n糾弾\nblame, cause of\nPastalie [Unofficial]
c.z.	[suzu]\nE.v.\n変化する\ntransform\nNew Testament of Pastalie
calamila	[?]\nnoun\n禍い \ncatastrophe \nUnknown [Unofficial]
cause	[kauze]\nv.\n呪う、苦しめる\ncurse, torment\nMetafalss Note
cecet	[keketo]\nn.\n盾\nshield\nCentral Standard Note
ceku	[seku]\nn.\n友・友人・同士・同胞\nfriend, comrade, companion, comrade\nNew Testament of Pastalie
celetille	[sereteiru]\nadj.\n鮮やかな、新鮮な、美しい、綺麗な\nvivid, clear, fresh, beautiful\nCentral Standard Note
celle	[serure]\nadv.\n天高く\nheavenly\nCentral Standard Note
cenjue	[chienjue]\nv.\n変化する、変える、変更する (chsより強烈であり、強制力の強いもの。既に「願い」ではなく「使役」。正教語であり一般人は使えない。「na」と合わせることで、「逆言」的な効果を持って強固な意志を表現する。)\nchange, transform (Note: Has stronger connotations than ""chs"". This one doesn't mean the ""wish"" to change, but rather actually changing. It's an orthodox word not used by normal people. If it's preceeded by ""na"", then it takes the opposite meaning: indicating extreme firmness and determination)\nMetafalss Note
cerchio	[chierukio]\nn.\n可能性\npossibility\nCentral Standard Note
cest	[sesuto]\nadj./n.\n真実の、真の、本当の、真実\nof the true, true, real, truth\nCentral Standard Note
cexm	[sezumu]\nv.\n（人や物が）来る、訪れる\ncome (person), visit\nCentral Standard Note
chanti	[shantei]\nn./v.\n褒める、賞讃する、賞賛\npraise, reward\nCentral Standard Note
chess	\nn./v.\n接吻する\nkiss\n
chiess	[chiesu]\nn./v.\nキスする、口づけする、キス\nkiss\nCentral Standard Note
chs	[chisu]\nv.\n～になる (自分自身の形が完全に変わってしまうとき、もしくはモノの例えとして使う場合はこちら。何かと使われることが多い。)\nbecome (Note: Used metaphorically for whenever one wishes to change completely. It has an enormous variety of uses)\nCentral Standard Note
chsee	[chi^se]\nv.\n～に変化する (自分や対象物に何かがプラスされる、一部変化する、何かが減るといった、部分的な物理変化を意味する。)\ntransform into ~ (Note: Indicates increase, partial change or reductions on oneself or in the target. In short, it's used to express partial physical change).\nCentral Standard Note
chyet	[shietsu]\nadj.\n選ばれた、特別\nchosen, particular\nCult Ciel Note
cia	[shia]\nn.\n空\nsky\nNew Testament of Pastalie
ciel	[shie^ru]\nn.\n空、（意訳で）世界\nsky, (translated usually as) world\nCentral Standard Note
ciellenne	[shierure^nie]\nn.\n天空\nthe skies\nCentral Standard Note
cietta	[?]\nconjunction\nだって \nbecause, but, although \nUnknown [Unofficial]
clalliss	[kurarisu]\nn./v.\n色、色をつける\ncolor\nCentral Standard Note
clamour	[kurama^]\nn.\n膝\nknee, lap\nCentral Standard Note
clare	[kurare]\nadj.\n透明な 透き通った\nclear, transparent\nCentral Standard Note
clemezen	[kuremuzen]\nadj./n.\n狂気、気が触れた、狂った\ninsane, insanity\nCentral Standard Note
clyncye	[kurinshie]\nn.\n純粋、無色\npurity, colorlessness\nCult Ciel Note
coall	[?]\nverb\n還る \nreturn \nUnknown [Unofficial]
colga	[kuoruga]\nn.\n氷\nice\nCentral Standard Note
colgen	[?]\nv./adj.\n凍った\nfreeze, frozen\nUnknown [Unofficial]
coree	[?]\npreposition\n胸の中の \nwithin my heart \nUnknown [Unofficial]
corle	[?]\nnoun\nかけら \nshard, fragment \nUnknown [Unofficial]
corpu	[?]\nnoun\n肉体 \nbody, flesh \nUnknown [Unofficial]
crannidale	[kuranida^re]\nv.\n分かち合う\nshare, (possible alternate translation) believe\nMetafalss Note
cremia	[?]\nv./n,\n救済\nsalvation\nUnknown [Unofficial]
crown	[?]\nn.\n杯\ncup (for beverages)\nUnknown [Unofficial]
crudea	[kuru^dea]\nn.\n苦しみ、苦悩\nanguish, suffering\nMetafalss Note
crushue	[kurushu^e]\nv.\n紡ぐ\nspin (fabric), (translated usually as) craft\nMetafalss Note
cupla	[kyupuru]\nn.\n罪\nsin\nCentral Standard Note
cyuie	[kyui]\nadj.\n切ない、悲しい\nsad, sorrowful\nCentral Standard Note
cyurio	[kyurio]\nn.\n理、秩序\nreason, logic, order\nCentral Standard Note
d.n.	[doun]\nE.v.\n踊る\ndance\nNew Testament of Pastalie
d.n.g.	[?]\nE.v.\n穿つ\npierce\nPastalie [Unofficial]
d.r.s.n.	[?]\nE.v.\n伝えられている\nhanded down, passed down, passed on\nPastalie [Unofficial]
d.s.s.n.	[?]\nE.v.\n解決を求める\naccept the atonement\nPastalie [Unofficial]
d.z.	[zu]\nE.v.\n死ぬ\ndie\nNew Testament of Pastalie
daedu	[daedousu]\nn.\n醜いもの\neyesore, something ugly\nNew Testament of Pastalie
daf	[?]\npreposition\n? \nfor, that \nUnknown [Unofficial]
dand	[dando]\nn.\nドア\ndoor\nCentral Standard Note
dauan	[dauan]\nn.\n夜明け\ndawn\nCentral Standard Note
dauane	[dauane]\nadj.\n夜明けの\nof the dawn\nCentral Standard Note
dazua	[?]\nn./adj.\n闇\ndarkness, dark\nPastalie [Unofficial]
dea	[?]\npreposition, particle\n~で \nwith, by means of \nUnknown [Unofficial]
deata	[da^te]\nv.\n裁かれる、裁きをうける、断罪される\njudge, convict, administer judgment\nCult Ciel Note
deggeez	[deiji^zu]\nv./n.\n裏切る、背く\nbetray, disobey, betrayal\nCentral Standard Note
degle	[deguru]\nv.\n滅ぼす\ndestroy, overthrow, ruin\nCult Ciel Note
dejuy	[dejui]\nn.\n贖罪\natonement\nNew Testament of Pastalie
deleir	[dereia]\nn.\n災い、禍、災厄\ncalamity, disaster\nAlpha Note (EOLIA)
delij	[douerijji]\nv.\n嫌う、嫌がる、疎む\nhate, shun, neglect\nAlpha Note (EOLIA)
den	[den]\nconj.\nしかし、でも、けれど、～だが (反対の接続語)\nhowever, but, still, and yet (Note: Connective for opposite sentences)\nCentral Standard Note
denera	[denera]\nn.\n悪しきもの\nevil one\nCentral Standard Note
der	[dea]\nprep.\n～で、によって\naccording to, by means of\nMetafalss Note
desfel	[deisuferu]\nadj./v.\n嫌い、厭、厭う、いやがる\nhate, dislike, detestable, unpleasant\nMetafalss Note
dest	[?]\nverb\n滅びる、消滅する \ndestroy, obliterate, bring to an end \nUnknown [Unofficial]
deu	[?]\npreposition, particle\nそして、～と \nthus, therefore, and \nUnknown [Unofficial]
dewee	[?]\nv.\n跪け\nkneel\nUnknown [Unofficial]
dgal	[?]\nn.\n国\ncountry, land\nPastalie [Unofficial]
dhezeall	[dei^jiaru]\nn./adj.\n虜囚、虜、捕らわれ人 (囚われの、という形容詞としても使用可)\ncaptive, prisoner, imprisoned\nMetafalss Note
diasee	[deiazuie^]\nn.\n神の子\nchild of God\nMetafalss Note
didalia	[daidaria]\nadj.\n大きい\nlarge\nCult Ciel Note
dilete	[deire^te]\nn.\n神の息吹 神の加護 (詩魔法の効能は防御とステータス上昇)\nGod's breath, God's divine protection (Song Magic effects is defense and status increases)\nCentral Standard Note
discest	[deisesuto]\nv./n.\n偽る・偽装する・騙す・偽り (動詞・名詞同形で使用可)\nlie, cheat, trick\nCentral Standard Note
dius	[deiusu]\nadj.\n尊い、神々しい\ndivine, sacred, precious, valuable, sublime, solemn, noble\nCult Ciel Note
diviega	[deivie^ga]\nn., adj.\n聖なる剣、(転じて)偉大なる叡智\nsacred sword, (derivative meaning) great wisdom\nCult Ciel Note
dje	[?]\nn.\n体\nbody\nPastalie [Unofficial]
dn	[doun]\np.\n～で ( 手段。byに相当)\n(instrument/location/cause/time marker) (Note: Used to indicate means. Equivalent to the English ""by"").\nNew Testament of Pastalie
doodu	[do^dou]\nn.\n大地\nground, earth\nNew Testament of Pastalie
dople	[dopure]\nv.\n排除する\nremove, exclude, reject\nCentral Standard Note
dor	[do^ru]\nn.\n大地、大陸\nground, continent\nCentral Standard Note
dorn	[dorun]\nn.\n木\ntree, wood\nCentral Standard Note
dornpica	[dourunpika]\nn.\n木の実\nnut, fruit, seed\nCult Ciel Note
dralee	[?]\nv./n.\n供物\nOffer, offering\nUnknown [Unofficial]
drone	[douro^ne]\nv.\nダウンロード、取り込む\ndownload, take in\nCentral Standard Note
dsier	[diea]\nn.\n欲望\ndesire\nCentral Standard Note
du	[dou]\np.\n～を\n(direct object marker)\nNew Testament of Pastalie
dyya	[dei^a]\nn.\n日（英語のDay） (『一日』や『その日』など時間や期間を表す為に用いる。『何日目』の場合はdyyalを参照)\nday (Note: Used only for phrases such as ""one day"" or ""that day"". For phrases with aa definite number of days, ""dyyal"" is used instead)\nCentral Standard Note
dyyal	[dei^aru]\nn.\n～日目\ndays (counter suffix)\nCentral Standard Note
eazas	[i^zasu]\nadj.\n互いに (愛し合う→hartes eazasのように、動詞の後に付けて使う)\nmutually (Note: It can be attached to the end of a verb, like this: ""hartes eazas"" -> ""mutual love"")\nCentral Standard Note
echrra	[ekura]\nv.\n共鳴する\nresonate\nCentral Standard Note
ee	[iee]\nv.\n偉大なる、讃える\nexalt, praise\nMetafalss Note
eetor	[etou^]\nn.\n向こう側\nother (side/person)\nCentral Standard Note
eje	[ejie]\nn.\n心、気持ち\nheart, mind, feeling\nNew Testament of Pastalie
elle	[eru]\nprep.\n～から、～よりの、～より (fromに近い意味を持つ単語)\nfrom, out of (Note: It's similar in meaning and use to the English ""from"")\nCentral Standard Note
elye	[erie]\nadv.\n未だ、まだ\nhitherto, yet\nNew Testament of Pastalie
en	[en]\nconj.\nそして、～だから、～ために (英語のandです)\nand, because, for (Note: Direct equivalent to the English ""and"")\nCentral Standard Note
enclone	[enkuroune]\nv.\n包み込む\nwrap up\nMetafalss Note
endia	[endeia]\nv.\n止める、終わらせる\nstop, end\nMetafalss Note
ene	[enu]\nv.\n思う、感慨深くなる\nthink, feel deeply\nCult Ciel Note
enegd	[enegudou]\nv.\n痺れる\nbecome numb\nCentral Standard Note
enerel	[enereru]\nadv.\nずっと\nalways, forever\nCult Ciel Note
enesse	[enesse]\nn.\n想い\nemotion\nCult Ciel Note
engassya	[enga^sha]\nn.\n生け贄\nsacrifice\nCentral Standard Note
engua	[?]\nadjective\n? \npredestined, inevitable, unchangeable \nUnknown [Unofficial]
enne	[enie]\nn.\n祈り、願い（いい意味）\nprayer, request (with good intentions)\nCentral Standard Note
enrer	[enrya]\nadv.\n常日頃から、いつも\nalways, usually\nCult Ciel Note
enter	[enteru]\nverb\n〜に入り込む \nenter \nCentral Standard Note
envied	[?]\nadjective\n愚か \nstupid, idiotic \nUnknown [Unofficial]
enw	[en'u]\nconj.\n～しながら\nwhile doing ~\nCentral Standard Note
erlla	[?]\nadjective, adverb\nもっと \nvery much, more, further \nUnknown [Unofficial]
erphy	[?]\nnoun\n思い出 \nmemory, rememberance \nUnknown [Unofficial]
erra	[e^ra]\nE.s. III\n永遠にこのままでいたい\nI want this to last eternally\nCentral Standard Note
ess	[e^su]\nprep.\n～で (英語のin相当)\n(instrument/location/cause/time marker) (Note: Equivalent to the English ""in"")\nNew Testament of Pastalie
et	[e]\nadj.\n大きい\nlarge\nCentral Standard Note
eta	[e^ta]\nv.\n食べる\neat\nCentral Standard Note
etealune	[eterunee]\nn.\n永遠、永久\neternity\nMetafalss Note
eterne	[ete^rune]\nn.\n永遠、永久\neternity\nAlpha Note (EOLIA)
eux	[yukusu]\nn.\n目\neye\nCentral Standard Note
ewle	[?]\nadj.\n長い\nlong\nUnknown [Unofficial]
exali	[?]\nadj.\n眩しい\nradiant, dazzling\nPastalie [Unofficial]
exec	[eguzeku]\nv.\n実行する\nexecute, put into practise\nCentral Standard Note
f.p.n.	[?]\nE.v.\n降りしきる\ndownpour\nPastalie [Unofficial]
f.r.l.	[fururu]\nE.v.\n怯える\nbe frightened\nNew Testament of Pastalie
f.s.	[efusu]\nE.v\n囁く\nwhisper, murmur\nNew Testament of Pastalie
f.w.r.	[fuuru]\nE.v.\n受け入れる\naccept\nNew Testament of Pastalie
f.w.r.n.	[fuurun]\nE.v.\n包みこむ\nsurround, enfold\nNew Testament of Pastalie
faf	[fafu]\nadj.\n怖い\nscary, frightening\nCult Ciel Note
faiy	[?]\nadj.\n刹那の\nmomentary, transient\nUnknown [Unofficial]
faja	[fa^ja]\nv.\n進む (主に普通に進む場合はこちら。集団で移動する場合はZahha)\nadvance, make progress (Note: It's used for indicating the advancing of an individual or small groups. For the advancing of large groups, ""Zahha"" it's used instead).\nCult Ciel Note
falfa	[?]\nn.\n安寧\npeace\nUnknown [Unofficial]
famfa	[fanfa]\nv.\nはばたく\nfly, flap wings\nCentral Standard Note
fanalea	[?]\nadj.\n高らかに\nloudly, sonorously\nUnknown [Unofficial]
fandel	[fanderu]\nadj.\n数多の、幾多の\nmany, in great numbers\nMetafalss Note
fane	[fa^ne]\nn.\n慈愛\naffection, kindness, love\nCentral Standard Note
fatele	[fatere^]\nn.\n父\nfather\nMetafalss Note
fatere	[fa^tere]\nadv.\nさもなくば・そうしなければ～でしょう\nif not ~ then probably ~\nCentral Standard Note
fau	[fau]\nn.\n鳥 (「小」鳥ではない)\nbird (Note: not used for small birds)\nMetafalss Note
faura	[faura]\nn.\n小鳥、幼い鳥\nsmall/baby bird\nMetafalss Note
fayra	[faira]\nn.\n火、炎\nfire, blaze\nCentral Standard Note
fedyya	[fidei^a]\nn.\n明日 (未来の意味でも使用可)\ntomorrow (Note: Can also mean ""future"")\nCentral Standard Note
fee	[?]\nn.\n風\nwind\nUnknown [Unofficial]
ferda	[feruda]\nv.\n宿る\ndwell, live in\nMetafalss Note
fernia	[fe^nya]\nv.\n微笑む\nsmile\nCult Ciel Note
fhau	[?]\nnoun\n光 \nlight \nUnknown [Unofficial]
fhauri	[?]\nadjective\n光の \nlight-borne \nUnknown [Unofficial]
fhyu	[hyufu]\nn.\n風\nwind\nCentral Standard Note
firanzia	[?]\nn.\n世の終焉\nend of the world\nUnknown [Unofficial]
firga	[?]\nnoun\n過去 \npast \nUnknown [Unofficial]
firle	[firure]\nv.\n感じる\nfeel, sense\nMetafalss Note
flare	[furare]\nv.\n浮かぶ 浮く\nfloat, suspend (in the air)\nCentral Standard Note
flip	[furipu]\nv.\nひっくり返る、フリップフロップ転送コマンド\nreverse, command for flip-flop conversion\nCult Ciel Note
fluy	[furyui]\nn.\n泉、湧水\nspring, well\nCentral Standard Note
focs	[?]\nadj.\n深い\ndeep, thick\nUnknown [Unofficial]
fogabe	[fo^geibu]\nv.\n許す\nforgive, allow, pardon\nCentral Standard Note
folten	[foruten]\nprep.\n前 （位置、方向を指す）\nbefore (position/direction), in front of\nCentral Standard Note
forgandal	[fo^gandaru]\nCon.\nなぜならば！\nBecause of...!\nCult Ciel Note
forlindel	[fo^rinderu]\nn.\n村長の一族\nhead family of a village\nCult Ciel Note
forlinden	[fo^rinden]\nn.\n村\nvillage\nCult Ciel Note
foul	[fouru]\nn.\n不思議、神秘\nwonder, miracle, mystery\nCult Ciel Note
fountaina	[faunteina]\nv./adj.\n覆う、満たす、埋める (覆うような、など、量や規模を表す形容詞としても同形で使用可)\nfill up, cover, hide (Note: It can also be used as an adjective to indicate the amount and scope of something)\nCentral Standard Note
fowrlle	[fowa^ru]\nv./n.\n慰める、癒す、慰安\ncomfort, heal, relaxation\nCentral Standard Note
frawr	[ra^wa]\nn.\n花\nflower\nCentral Standard Note
frawrle	[rawa^ru]\nn.\n春\nspring (season)\nCult Ciel Note
frissoner	[furissonea]\nv.\n震える\nshiver\nCentral Standard Note
frreie	[?]\nv.\n解き放つ\nrelease\nUnknown [Unofficial]
fs	[fusu]\nn.\nそよ風 (Eをつけると意訳で「ささやき」)\nbreeze (when it has an ""E"" emotion vowel in front, its meaning changes to ""whisper"").\nNew Testament of Pastalie
ftt	[futsu]\nv.\n消える\nvanish\nCentral Standard Note
fulual	[furuaru]\nv.\n叶う\ncome true (wish)\nCentral Standard Note
fusya	[fu^sha]\nv.\n包む\nwrap\nCentral Standard Note
futare	[futa^re]\nn.\n未来\nfuture\nCentral Standard Note
fwal	[fuwaru]\nn./v.\n翼, 進める, 運ぶ\nwing, advance, transport\nCult Ciel Note
fwilla	\nn.\n雫\ndrop, droplet\n
fwillra	[fira]\nn.\n羽、羽毛、ひとひら (fwalは翼、fwillraは羽や羽毛のひとひら)\nfeather, plumage, petal (Note: contrary to ""fwal"", which means ""wings"", ""fwirlla"" only refers to the feathers and plumage)\nCult Ciel Note
g.k.n.	[gatsun]\nE.v.\nたべる\neat\nNew Testament of Pastalie
g.v.w.	[?]\nE.v.\n戦う\nfight, battle\nPastalie [Unofficial]
g.w.f.r.	[guufuru]\nE.v.\n裁く\njudge\nNew Testament of Pastalie
g.w.n.	[?]\nEmotion Verb\n導く \nlead, guide \nPastalie [Unofficial]
ga	[ga]\nE.s. III\nはやく脱したい\nI want this to end soon\nCentral Standard Note
gagis	[gyagisu]\nE.s. III\n自分はどうなってもいい\nI'm all right like this\nMetafalss Note
ganna	[gana]\nadj./n.\n固い、頑なな、堅牢な、石、岩 (物質・精神両方の意味で「カタイ」ものの表現に使用可。名詞としては石や岩も指す。\nstrong, stubborn, solid, stone, rock (Note: It's normally used to indicate the hardness of a material or the stubbornness of a mind. As a noun, it means ""rock"" and ""stone"")\nCentral Standard Note
garlden	[garuden]\nn.\n町\ntown\nCentral Standard Note
gasar	[gasaru]\nn.\nぬいぐるみ\ndoll, stuffed animal\nNew Testament of Pastalie
gat	[gatto]\nn.\n呪い\ncurse\nCentral Standard Note
gatyunla	[gachunra]\nn.\n呪いの地、地獄\ncursed land, hell\nCult Ciel Note
gatyuny	[gachuni]\nn.\n呪い\ncurse\nCult Ciel Note
gaunji	[?]\nv.\n苛む\ntorment, torture\nUnknown [Unofficial]
gauto	[?]\nnoun\n暗い空、曇天、暗い曇 \ndark skies, overcast, dark clouds \nUnknown [Unofficial]
gauv	[?]\nn.\n罪、咎\nsin, blame\nUnknown [Unofficial]
gauzewiga	[gaunze^vi^ga]\nv.\n絶望する\ndespair\nMetafalss Note
gaya	[gaya]\nE.s. III\n二度と先の状態に戻りたくない\nI never want to go back to how I was before\nCentral Standard Note
geeow	[gio]\nn./v.\n誓い、誓う、決意(する)\noath, vow, resolve\nCentral Standard Note
getrra	[gettora]\nadj.\n汚れた\ndirty, impure\nCentral Standard Note
gfine	[?]\nnoun\n時間 \ntime \nUnknown [Unofficial]
gigeadeth	[gigadeisu]\nadj./n.\n鋼鉄の、鉄 (形容詞・名詞同形で使用可)\nsteel, iron (Note: It can be used both as an adjective and a noun)\nCentral Standard Note
giue	[?]\nn.\n体\nbody\nUnknown [Unofficial]
giz	[?]\nn./v.\n恐怖\nfear, dread, terror\nUnknown [Unofficial]
gkgul	[gukkuru]\nadj.\nひび割れた\ncracked\nNew Testament of Pastalie
glansee	[guranzui]\nadj.\n神々しい、偉大な (LYAをつけると意訳で「神」)\ndivine, exalted (Note: adding ""LYA"" before it changes its meaning to ""God"").\nNew Testament of Pastalie
glasden	[gurasuden]\nadj.\n最高\nhighest, supreme, most\nMetafalss Note
goa	[goa]\nconj.\n～だけ (only)\nonly ~ (it's used in the same way as the English ""only"")\nNew Testament of Pastalie
gool	[gu^ru]\nadjective\n飢えた \nstarved, parched \nCentral Standard Note
got	[gotto]\nv.\n手に入れる\nget, obtain\nCult Ciel Note
gott	[gotto]\nv\n離れろ！退け！（汚い感じ）\nGet off! Go away! (dirty feeling)\nCentral Standard Note
govan	[?]\nadj.\n激しい\nviolent, excited, vehement, intense\nPastalie [Unofficial]
govaz	[go^vazu]\nn.\n許嫁\nfiancee\nCult Ciel Note
gral	[guraru]\nadj.\n全て\nall of, entire\nNew Testament of Pastalie
gran	[guran]\nv.\n幕を開ける\nopen the curtain\nCult Ciel Note
grandee	[gurandeie^]\nn.\n守護者\nguardian\nMetafalss Note
grandus	[gurandousu]\nv.\n護る\ndefend, protect\nMetafalss Note
granme	[guranme]\nE.s. II\n心に勇気を抱く 護りたいと想う\nWishing to protect someone, courage\nCentral Standard Note
grave	[gureivu]\nn.\n山奥、建物などの奥\nmountain recesses, interior (of a building, etc.)\nCult Ciel Note
grlanza	[gurantsua]\nv.\n踊る\ndance\nCentral Standard Note
grow	[?]\nadjective\n傲慢 \ninsolent, arrogant \nUnknown [Unofficial]
grrena	[gurena]\nadj./n.\n緑 緑色の 碧 (名詞としても使用可. 植物という意味の緑は指さない)\ngreen (Note: It can be used both as a noun and adjective. As a noun, it's used for non-green plants)\nCentral Standard Note
grruw	[guruu]\nv.\n育つ\nraise, grow up\nCentral Standard Note
guard	[guarudo]\nn.\n守り、防御\nprotection\nCentral Standard Note
guatrz	[go^tsu]\nn.\n怒り、憎悪\nanger, hatred\nCentral Standard Note
guaysu	[guaisu]\nv.\nうつむく\nhang one's head (in shame, etc.)\nCentral Standard Note
guol	[guoru]\nv.\n（扉などを）閉じる\nclose (a door, etc.)\nCentral Standard Note
guwo	[guuo]\nE.s. II\n怒る 憤り\nanger, resentment\nCentral Standard Note
gyaje	[gyajie]\nn.\n過ち\nerror, mistake\nCentral Standard Note
gyajlee	[gyajiere]\nn.\n罪人\ncriminal, sinner\nCult Ciel Note
gyas	[gyasu]\nn.\n悪霊、悪い成分\nevil spirit, bad component\nCentral Standard Note
gyen	[jien]\nv.\n紡ぐ、（魔法を）生み出す\nspin, craft, create magic\nCult Ciel Note
gyenel	[jieneru]\nn.\n魔道士\nwizard, mage, sorcerer\nCult Ciel Note
gyengyat	[jienjatto]\nv.\nむさぼり食う\ndevour, lustfully eat\nCult Ciel Note
gyuss	[gyusu]\nn.\n抱擁\nembrace, hug\nCentral Standard Note
gyusya	[gyusha]\nv.\n支配する\nrule, control\nCentral Standard Note
h.k.t.t.	[hakuto]\nE.v.\n抱擁する、抱きしめる\nembrace, hug\nNew Testament of Pastalie
h.l.s.s.	[furusu]\nE.v.\n嘆く\ngrieve, sigh\nNew Testament of Pastalie
h.m.m.r.	[fumuru]\nE.v.\n謳う\nsing\nNew Testament of Pastalie
h.p.p.	[fupu]\nE.v.\n想う\nthink, feel\nNew Testament of Pastalie
h.p.ps.	[fuppusu]\nE.v.\n思いを馳せる\nhave (someone) on one's mind\nNew Testament of Pastalie
h.r.n.t.	[hanto]\nE.v.\n旅をする\ngo on a journey\nNew Testament of Pastalie
h.w.s.s.	[fuusu]\nE.v.\n成長する\ngrow, mature\nNew Testament of Pastalie
haf	[hafu]\nv.\n持っている、所有する、手に取る\nhave, own, hold\nCentral Standard Note
handeres	[henderesu]\nn./v.\n敗北(する)、負け\ndefeat, loss\nCentral Standard Note
hao	[hao]\nadj.\n上、上位、高位、上級\nabove, superior\nCentral Standard Note
harmon	[ha^mon]\nv.\n（多数で）合わせて～する\ndo ~ together (in great numbers)\nCentral Standard Note
harphe	[harufe]\nn.\n朝\nmorning\nNew Testament of Pastalie
harr	[haruru]\npro.\n彼女（主語定義）\nshe\nCentral Standard Note
harra	[harurura]\npro.\n彼女ら（主語定義）\nshe (plural)\nCentral Standard Note
hars	[harusu]\nn.\n彼女ら\nher (plural)\nCentral Standard Note
hartes	[ha^tesu]\nv.\n愛する\nlove\nCult Ciel Note
harton	[ha^ton]\nn.\n愛\nlove\nCentral Standard Note
has	[hasu]\nn.\n彼女\nher\nCentral Standard Note
hasyu	[hashu]\nn.\n魚\nfish\nCentral Standard Note
heath	[hi^su]\nadj.\n灼熱の 高温の\nscalding hot\nCentral Standard Note
heetha	[hii^sa]\nadj./n.\n健やか、健康\nhealth, healthy\nCentral Standard Note
heighte	[heite]\nv.\n傷つける\ninjure, wound\nMetafalss Note
hellei	\nE.s. II\n\n(unknown meaning)\n
her	[ia]\npro.\nこれ、この\nthis\nCentral Standard Note
here	[ia]\nadv.\nここ\nhere\nCentral Standard Note
herr	[heruru]\npro.\n彼（主語定義）\nhe\nCentral Standard Note
herra	[herurura]\npro.\n彼ら（主語定義）\nhe (plural)\nCentral Standard Note
hers	[he rusu]\nn.\n彼ら\nhim (plural)\nCentral Standard Note
hes	[hesu]\nn.\n彼\nhim\nCentral Standard Note
hieg	[hi^gu]\nadj./v.\n悲しむ、悲しみの\nsad, to be sad\nCentral Standard Note
hierle	[heiarure^]\nadj./v.\n悲しむ、悲しみの\nsad, to be sad\nMetafalss Note
hiew	[hi^u]\nn.\n哀しみ、悲哀\nsadness\nNew Testament of Pastalie
hiewi	[hi^ui]\nadj.\nつらい、悲しい\nheart-breaking, sad\nNew Testament of Pastalie
hiralg	[?]\nn.\n渇き\nthirst\nUnknown [Unofficial]
hopb	[hoppu]\nn.\n心（事象として表現する場合）\nheart, mind (when presenting it as a phenomenon)\nCult Ciel Note
houd	[houdo]\nv.\n抱く\nembrace, hug\nCentral Standard Note
how	[?]\nconj.\n~のように\nhow, like ~\nUnknown [Unofficial]
hueaf	[hyafu]\nadj./n.\n無駄な、くだらない、徒労\nfutile, useless, worthless, waste of effort\nCentral Standard Note
hyear	[iea , ya]\nint.\nさあ、やあ、ねえ（呼びかけ語句） (呼びかけや感嘆。非常に軽く発音するとほとんど「や」にしか聴こえない)\nhey, you (to get someone's attention) (Note: Used both for admiration and calling. It can be pronounced as ""hyear"" or ""ya"", but generally, ""ya"" is the only way used because of being faster to pronounce)\nCentral Standard Note
hyma	[hyuma]\nv.\n（言葉を）聞く\nlisten (to words)\nCentral Standard Note
hymma	[hyunma]\nn.\n小鳥 (語源は「奏でる者」でhymmeから来ている。)\nsmall bird (Note: This word originally meant ""music player"", and it originated from ""hymme"").\nCentral Standard Note
hymme	[hyumu]\nv./n.\n謳う、奏でる、共鳴する (名詞的使い方をする場合もある。その場合は、波動、波など、形のない振動を指す。)\nsing, play (a instrument), resonate (Note: It can be also used as a noun. In that case, it would mean ""waves"", ""waving"", and ""vibration of formless things"").\nCentral Standard Note
hymmne	[hyumune]\nn.\n波動、調べ、メロディ (hymmnosよりも軽い、意味的にも浅いもの。)\nsound waves, tune, melody (Note: Has lighter connotations than Hymmnos. It actually is used for talking about songs in a more superficial form).\nCentral Standard Note
hymmnos	[hyumunosu]\nn.\n詩、ヒュムノス\nsong, Hymmnos\nCentral Standard Note
hynne	[hyun]\nn.\n声\nvoice\nCentral Standard Note
hyzik	[fijiku]\nn.\n肉体、体\nbody\nAlpha Note (EOLIA)
i	[i]\nE.s. II\n焦り\nimpatience\nCentral Standard Note
iasien	[iashien]\nn.\n朝露\nmorning dew\nCult Ciel Note
ides	[idesu]\nn.\n過去\npast\nCentral Standard Note
idesy	[ideshi^]\nadj.\n過去の\nof the past\nCentral Standard Note
ieeya	[i^ya]\nn.\n希望\nhope, wish\nCentral Standard Note
iem	[iemu]\nn.\n今\nnow\nMetafalss Note
infel	[inferu]\nn.\n愛 (infel yor で「ありがとう」という意味に)\nlove ( Note: ""infel yor"" means ""thank you"")\nMetafalss Note
inferiare	[inferia^re]\nadj.\n親愛なる\nbeloved\nMetafalss Note
ini	[ini]\nv.\n初期化する、清純化する\ninitialize, purify\nCult Ciel Note
innna	[inna]\nn.\n（精神世界的な）中、心の中\ninside (of the Soulspace), within one's heart\nCult Ciel Note
irs	[irusu]\nv.\nいる、存在する\nexist\nCentral Standard Note
j.d.r.	[?]\nE.v.\n囚われる\naprehend, capture\nPastalie [Unofficial]
j.l.j.	[jierujie]\nE.v.\nとらわれる、固執する、はまる\ncapture, adhere, take in\nNew Testament of Pastalie
j.l.r.	[ju^ru]\nE.v.\n我に返る、正気に戻る\ncalm down, return to one's self\nNew Testament of Pastalie
j.w.	[jieu]\nE.v.\n託す\nentrust\nNew Testament of Pastalie
j.z.t.	[jiezuto]\nE.v.\n発動する、実行する\nexecute, invoke\nNew Testament of Pastalie
jam	[jamu]\nadv.\n一緒に\ntogether\nCentral Standard Note
jambea	[janbea]\nn.\n足\nfoot, leg\nCentral Standard Note
jass	[jasu]\nv.\n求める\nseek, request, wish for\nCentral Standard Note
jastil	[?]\nv.\nいくぞ！\nCome!, Let's go!\nUnknown [Unofficial]
jefea	[?]\nadj.\n悼ましい\nlamenting, grieving\nUnknown [Unofficial]
jenge	[jienjie]\nn.\n敵\nenemy, rival, opponent\nCult Ciel Note
jenhah	[jienha^]\nn.\n不幸、災い\ndisaster, misfortune\nCult Ciel Note
jouee	[jue]\nn.\n神の力\nGod's power\nCentral Standard Note
jue	[?]\nn.\n水\nwater\nPastalie [Unofficial]
jyel	[jie^ru]\nE.s. II\n寂しい\nloneliness\nCentral Standard Note
k.f.k.k.	[?]\nE.v.\n嘲笑う\nsneer, ridiculize, scorn\nPastalie [Unofficial]
k.r.	[kuru]\nE.v.\n戯れる、じゃれ合う\nplay, frolic\nNew Testament of Pastalie
k.v.n.r.	[kevunru]\nE.v.\n挑む・挑戦する\nchallenge, defy\nNew Testament of Pastalie
k.v.r.	[?]\nE.v.\n覆う\ncover, wrap\nPastalie [Unofficial]
kajya	[kaja]\nadj.\n必要\nnecessary, needed\nNew Testament of Pastalie
kapa	[kapa]\nn.\n水\nwater\nCult Ciel Note
karf	[?]\nparticle\nその \nthat, these \nUnknown [Unofficial]
keen	[ke^n]\nv.\n輝く\nshine\nCentral Standard Note
keenis	[kenisu]\nn.\n輝き\nradiance\nCentral Standard Note
keg	[kegu]\nn.\n枝\nbranch\nNew Testament of Pastalie
khal	[kuaru]\nv.\n護る\nprotect, defend\nCentral Standard Note
ki	[ki]\nE.s. II\n真剣、集中\nconcentration, focus, seriousness\nCentral Standard Note
kiafa	[kiafa]\nv.\n聴く\nhear, listen\nMetafalss Note
kiakkya	[?]\nnoun\nなかよし \nfriend \nUnknown [Unofficial]
kiala	[?]\nadjective, noun\n金 \ngold, golden \nUnknown [Unofficial]
kieghl	\n\n\n(unknown meaning)\n
kierre	[kie^rre]\nn.\n刻、瞬間\ninstant, moment\nMetafalss Note
kil	[kiru]\nv.\n殺す\nkill\nCentral Standard Note
knawa	[no^wa]\nv.\n知る\nknow\nCentral Standard Note
kneet	[ni^to]\nadj.\n遅い、遅れて、手遅れ\nlate, be late, be too late\nCentral Standard Note
koffl	[?]\nverb\n飲む \ndrink \nUnknown [Unofficial]
konla	[?]\nnoun\n愛 \nlove \nUnknown [Unofficial]
koora	[ko^ra]\nn.\n小川\nstream\nCentral Standard Note
kouf	[ku^fu]\nn.\nため息\nsigh\nNew Testament of Pastalie
ks	[kesu]\nv.\n暗示を掛ける\ngive a hint\nCult Ciel Note
kuhle	[kyu^re]\nn.\n毒・毒薬\npoison\nCentral Standard Note
kvvia	[?]\nn.\n後悔\nregrets, repentance\nUnknown [Unofficial]
kvyeire	[?]\nn.\n終わり, 終焉\nend, ending\nUnknown [Unofficial]
kyll	[?]\nv.\n切る、切られる\ncut, detach\nUnknown [Unofficial]
l.k.k.	[?]\nE.v.\n見上げる\nlook up at, admire\nPastalie [Unofficial]
l.l.n.	[ririn]\nE.v.\n祝福する\nbless\nNew Testament of Pastalie
l.n.c.a.	[runka]\nE.v.\n繋がる\ntie together, connect\nNew Testament of Pastalie
la	[ra]\npre.\nそれこそ （強調する為の冠詞 母音の前）\n*that* (used to emphasize, in front of a vowel sound)\nCentral Standard Note
lamenza	[ramentsua^]\nn.\n嘆き\nlament, grief\nMetafalss Note
lamenzeo	[?]\nadjective, adverb\n嘆きの \nborne of laments, borne of grief \nUnknown [Unofficial]
lapo	[rapo]\nv.\n出逢う\nmeet (by chance), rendezvous\nCult Ciel Note
lasye	[rashie]\nn.\n少年\nboy, young man\nCentral Standard Note
lau	[?]\nEmotion Sound (II)\n慄く \nfear, dread \nUnknown [Unofficial]
lautyca	[?]\nverb\n零れてゆく \nfall down \nUnknown [Unofficial]
layy	[?]\nadj.\n嘘、虚構\nlie, false, imaginary\nUnknown [Unofficial]
leaff	[ri^fu]\nn.\n本、書物、絵本\nbook, books, picture book\nMetafalss Note
leat	[ri^]\nv.\n奏でる (謳う（hymme）に近いが、こちらの方が更に比喩的に使われる。)\nplay (instrument) (Note: It's very similar to the ""singing"" meaning of ""hymme"", but it's used in a much more figurative manner)\nCentral Standard Note
lequera	[rikuuira]\nn.\n善きもの\nGooddoer, good person\nCult Ciel Note
lhasya	[?]\nverb\n繋がる \nconnect, tie together \nUnknown [Unofficial]
li	[ri]\npre.\nそれこそ （強調する為の冠詞 子音の前）\n*that* (used to emphasize, in front of a consonant sound)\nCentral Standard Note
linen	[ri^nen]\nv.\n語る\ntalk, recite\nCult Ciel Note
lir	[rairu]\nn.\n光\nlight\nAlpha Note (EOLIA)
lirle	[rire^ru]\nn.\n夏\nsummer\nCult Ciel Note
llizz	[rizu]\nadv.\n～かもしれない、ひょっとすると、もしかしたら\npossibly, maybe, perhaps\nCentral Standard Note
lof	[rofu]\nn.\n場所\nplace\nCult Ciel Note
lonfa	[?]\nn.\n魂\nsoul\nUnknown [Unofficial]
lornya	[?]\nnoun\nはちみつ \nhoney \nUnknown [Unofficial]
loss	[?]\nadj.\n失なわれた、死なった\ndead, lost\nUnknown [Unofficial]
lulurnya	[?]\nnoun\n喜び \njoy, happiness \nUnknown [Unofficial]
lurrea	[ru^rrea]\nv.\n慄く\nfear\nMetafalss Note
lusye	[ru^shie]\nn.\n光\nlight\nMetafalss Note
lyafre	[ryafure]\nn.\n蝶\nbutterfly\nCult Ciel Note
lyrnya	[?]\nadjective\n安らぎ \ngentle, peaceful \nUnknown [Unofficial]
lyuma	[ryuma]\nn.\n星 (LYAをつけると意訳で「澪の御子」)\nstar, planet (Note: if it has a ""LYA"" before it, the meaning changes to ""Maiden of Mio"")\nNew Testament of Pastalie
m.a.m.	[mamu]\nE.v.\n存在する\nexist\nNew Testament of Pastalie
m.f.l.	[?]\nE.v.\n覆いつく\ncover, shroud\nPastalie [Unofficial]
m.n.g.	[ngu]\nE.v.\n飲み込む\ndrink, understand, learn\nNew Testament of Pastalie
m.r.r.	[?]\nE.v.\n映す\nreflect, project\nPastalie [Unofficial]
m.t.y.y.	[matoui]\nE.v.\n作り出す、生み出す\ncreate, give birth to\nNew Testament of Pastalie
maen	[maen]\nn.\n満月\nfull moon\nNew Testament of Pastalie
mahin	[maain]\nn.\n手\nhand\nCentral Standard Note
manaf	[manafu]\nn.\n命、生命\nlife, existence\nMetafalss Note
manafaln	[manafarun]\nn.\n転生\nreincarnation\nCult Ciel Note
manafeeze	[manafi^tsue]\nv.\n生きる\nlive\nMetafalss Note
maoh	[mao]\nnoun\nマオ \nMaoh, Rhaplanca's partner in Meta Falss mythology  \nMetafalss Note
marfo	[?]\nadjective\n愛しい \nbeloved, dear \nUnknown [Unofficial]
marta	[maruta]\nn./adj.\n母\nmother, motherly\nMetafalss Note
maun	[maun]\nn.\n瞼\neyelid\nCult Ciel Note
maxim	[makushimu]\nadj./adv.\n最も\nmost, extremely\nCentral Standard Note
maya	[maya]\nn.\n魔法、超自然\nmagic, supernatural\nCult Ciel Note
mea	[mi^a]\nn.\n私\nme (object)\nCentral Standard Note
mean	[mi^n]\nn.\nわたしたち\nus (object)\nCentral Standard Note
meaql	[?]\nadjective\n優しい \ngentle \nUnknown [Unofficial]
melenas	[merenasu]\nv.\n愛してる、大好きです (人生においてかけがえのない人にしか使わない。)\nlove, very fond of (Note: Used to talk about the most irreplaceable person to the speaker)\nCult Ciel Note
melifan	[merifan]\nn.\n歴史\nhistory\nMetafalss Note
melvaz	[meruvazu]\nn.\n花嫁\nbride\nCult Ciel Note
memora	[memo^ra]\nn.\n記憶\nmemory\nCentral Standard Note
meo	[meo]\nn.\n理想\nideal, dream\nCentral Standard Note
merfa	[?]\nadj./n.\n無垢な, 無垢な願い\npure, pure wishes\nPastalie [Unofficial]
merra	[?]\nn.\nわたしたち（主語定義）\nus (subject)\nCentral Standard Note
meryu	[meryu]\nn.\n記憶 (Aをつけると「夢（見る方）」に意訳する。)\nmemory (Note: if it's preceeded by an ""A"" emotion vowel, then its meaning is changed to ""dream"")\nNew Testament of Pastalie
meso	[meso]\nv.\n散らかす\nscatter, leave untidy\nCentral Standard Note
messe	[messe^]\nv.\n伝える\nreport, transmit, convey\nCentral Standard Note
milra	[?]\nnoun\n? \nfragrance \nUnknown [Unofficial]
mirie	[?]\nn.\n温かさ\nwarmth\nPastalie [Unofficial]
morto	[moruto]\nn./v.\n死 死ぬ\ndeath, die\nCentral Standard Note
murfan	[murufan]\nv.\n想う\nfeel, think\nMetafalss Note
murfanare	[murufana^re]\nn.\n想い\nfeeling, thought\nMetafalss Note
mutrk	[?]\nn.\n温かさ\nwarmth\nPastalie [Unofficial]
n.d.n.	[?]\nE.v.\n伏せる\nlay, put down, hide\nPastalie [Unofficial]
n.e.g.	[?]\nEmotion Verb\n祈る \npray \nPastalie [Unofficial]
n.m.l.	[nmu]\nE.v.\n染まる\ndye, color\nNew Testament of Pastalie
n.t.n.	[?]\nE.v.\n続く\ncontinue, go on\nPastalie [Unofficial]
na	[na]\nadv.\n否定、～ではない\nno, not, negation\nCentral Standard Note
naave	[naabe]\nconj.\nだから～\nbecause ~\nNew Testament of Pastalie
nafa	[nafa]\nadj.\n優しい\neasy, gentle\nNew Testament of Pastalie
nafan	[nafan]\nadj.\n優しく\nkind, tender\nNew Testament of Pastalie
naflansee	[nafuranzui^]\nn.\n幸せ\nhappiness, good fortune\nNew Testament of Pastalie
naja	[na^ja]\nv.\n後退する、さがる、逃げ去る、立ち去る\nescape, retreat, disappear, leave\nCult Ciel Note
near	[niea^]\nn.\n命、生命\nlife\nCentral Standard Note
neath	[?]\nadjective\n灼熱 \nred hot, scorching \nUnknown [Unofficial]
nedle	[nidouru]\nv.\n必要とする\nneed\nAlpha Note (EOLIA)
neee	[nee]\nv.\n呼ぶ\ncall out\nCentral Standard Note
neen	[ni^n]\nadjective, adverb\nあまりに～すぎる \ntoo much, excessive, beyond reason \nCult Ciel Note
neia	[neia]\nv.\n近づく、近寄る\napproach, draw near\nCentral Standard Note
nene	[nene]\nadj.\n分からない\nnot understand\nCult Ciel Note
nepo	[nepo]\nv.\n潤う\nmoisten\nCentral Standard Note
netvear	[netovia]\nv.\n諦める、挫ける、挫折する\ngive up, abandon, be discouraged\nCentral Standard Note
nezz	[nezu]\nn.\n鼻\nnose\nCentral Standard Note
nha	[nya]\nv.\n入れる、召喚する (物理的ではない、魔法的な場合に使用する。)\nlet in, summon (Note: It isn't used to refer to a physical phenomenon, rather, it's for situations were magic is being used)\nCult Ciel Note
nhaf	[?]\nadj.\n茫然と\nsurprised, dazed\nUnknown [Unofficial]
nille	[niru]\nv.\n似ている、類似、似る\nresemble, resemblance, be alike\nCentral Standard Note
nnoini	[noini]\nadv.\n初めて、初めての (イニ（初期化）とノイ（１）に由来する)\nfirst (Note: Combination of ""Nnoi"" (1) and ""Ini"" (Initialize))\nCentral Standard Note
noce	[no^se]\nn.\n自然\nnatural, spontaneous\nCult Ciel Note
noes	[noisu]\nn.\n自分自身\noneself\nCentral Standard Note
noglle	[noguru]\nadj./n.\n黒、黒い\nblack\nCentral Standard Note
nooge	[nu^gu]\nv.\n寝る\nsleep\nCult Ciel Note
nor	[?]\npre.\nか\nor, either\nUnknown [Unofficial]
nosaash	[no^sasshu]\nn.\n女神\ngoddess\nCult Ciel Note
nozess	[no^zesu]\nv.\n無にする、なくす\nlose, get rid of, waste\nCentral Standard Note
nuih	[nui]\nn.\n夜\nnight\nCentral Standard Note
num	[namu]\nE.s. II\n無\nnothing\nCentral Standard Note
nx	[nukusu]\nn.\n次\nnext\nCentral Standard Note
nyamo	[?]\nnoun, verb\n鳴き声、にゃも \nmeowing \nUnknown [Unofficial]
nyamonyas	[?]\nnoun\nともだち \nfriend \nUnknown [Unofficial]
nyanyas	[?]\nadj.\nかわいい\ncute, lovely, darling\nUnknown [Unofficial]
nyasri	[nyasuri]\nE.s. II\n悲しい\nsad\nCult Ciel Note
nyasyamorina	[?]\nadjective\nとてもしあわせ \nvery happy \nUnknown [Unofficial]
ocurp	[?]\nnoun\n河口 \nriver mouth \nUnknown [Unofficial]
ogbl	[?]\nverb\n渦巻する \ncoil into \nUnknown [Unofficial]
olo	[oro]\nn.\n夜\nnight\nNew Testament of Pastalie
omness	[?]\nn.\n生命\nlife, existence\nUnknown [Unofficial]
omnis	[omunisu]\nadj.\n全てを\neverything (direct object)\nMetafalss Note
oriye	[oriie]\nn.\n耳\near\nCentral Standard Note
orn	[?]\nadjective\n唯一つの \nonly, sole, unique \nUnknown [Unofficial]
orviclle	[o^vikuru]\nn.\n問題、障害 (na orviclle:無問題=大丈夫)\nproblem, question, obstacle (Note: na orviclle can mean ""no problem"" or ""it's okay"").\nCentral Standard Note
oter	[?]\npre.\n~から\nout from ~ (note: only used in Hymmnos Spells)\nUnknown [Unofficial]
oucc	[ouku]\nadv.\n一緒に\ntogether\nNew Testament of Pastalie
oure	[oure]\npre.\n何よりも\nmore than anything\nCentral Standard Note
ousye	[oushie]\nv.\n襲い掛かる、降りかかる\nlaunch an attack, fall onto\nAlpha Note (EOLIA)
ouvyu	[ouvuyu]\nn.\n廃墟\nruins\nNew Testament of Pastalie
ouwua	[ouea]\nadj.\nたくさんの\na lot, many, much\nNew Testament of Pastalie
oz	[ozu]\npre.\n～の（所有の助詞） (英語のofと同義（文脈によっては必ずしも必要ではない）\nof (possessive article) (Note: Equivalent to the English ""of"", though depending on context, it isn't always necessary)\nCentral Standard Note
p.s.w.t.	[pisuuto]\nE.v.\n掴む・獲得する\nseize, adquire\nNew Testament of Pastalie
pagle	[pagure]\nv.\n話す 喋る\ntalk, speak with\nCentral Standard Note
pak	[paku]\nv.\n（未来が）開く\nopen (the future)\nCentral Standard Note
paks	[pakusu]\nE.s. II\nドキドキ\nexcitement, nervouseness\nCentral Standard Note
pakz	[pakuzu]\nv.\n分ける\ndivide, separate\nCult Ciel Note
papana	[papana]\nn.\n雨\nrain\nCult Ciel Note
papas	[?]\nn.\n信じること\nbelief\nUnknown [Unofficial]
papulipua	[?]\nverb\n困る \nworry, bother \nUnknown [Unofficial]
parce	[pa^shie]\nn.\n証拠、証\nevidence, proof\nCentral Standard Note
parge	[pajie]\nv.\n切り離す (魔法的な場合) (物理的ではない、魔法的な場合に使用する。)\nto cut loose (in the case of magic) (Note: It isn't used to refer to a physical phenomenon, rather, it's for situations were magic is being used)\nCult Ciel Note
parith	[parisu]\nadj./n.\n正直、素直\nhonest, sincere\nCult Ciel Note
pat	[patsu]\nv.\n解放する\nrelease, set free\nCult Ciel Note
paul	[pauru]\nv.\n感じる\nfeel, sense\nCult Ciel Note
pauwee	[pauue^]\nn.\n力の子\nchild of power\nMetafalss Note
pauwel	[pauueru]\nn.\n力\npower\nMetafalss Note
pawr	[?]\nnoun\n力 \npower, strength \nUnknown [Unofficial]
pecee	[pishi]\nv.\n(卵が)孵る、孵化する\nhatch (egg), incubate\nCentral Standard Note
phira	[pira]\nn.\n種\nseed, kind\nMetafalss Note
phiz	[fizu]\nnoun\n身体 \nbody \nCult Ciel Note
phyue	[hyuu]\nn.\nおめでとう\ncongratulations\nCentral Standard Note
pic	[piku]\nv.\n気づく、はっとする\nrealize, take aback\nCentral Standard Note
pikca	[pikka]\nn.\n果物、実\nfruit, nut\nNew Testament of Pastalie
pilt	[piruto]\nv.\n気づく\nrealize\nCult Ciel Note
pipel	[piperu]\nadj./n.\n筒 筒状の\npipe, cylindrical\nCentral Standard Note
pipit	[pipitto]\nadj.\n僅かな\nonly, merely, a little\nNew Testament of Pastalie
pirtue	[pirichue]\nn.\n精霊\nspirit, ghost\nMetafalss Note
pitod	[pitoddo]\nadv.\n側に、共に、一緒に\nbeside, together\nCult Ciel Note
plina	[purina]\nn.\n緑（植物） (植物を指して言う場合の『緑』)\ngreenery (plants) (Note: Used only for talking about green plants)\nCentral Standard Note
poe	[poe]\nn.\n種\nseed, kind\nNew Testament of Pastalie
polon	[poron]\nn.\n孤独\nloneliness, solitude\nCult Ciel Note
pomb	[pomu]\nv.\n生む、産み出す\ngive birth, create\nCentral Standard Note
pono	[pono]\nn.\n卵\negg\nCentral Standard Note
pop	[popu]\nn.\n泡\nbubble\nNew Testament of Pastalie
porter	[porutea]\nv.\n着る 身に着ける 身に纏う\nwear (clothes)\nCentral Standard Note
prasrity	[purasuritei^]\nn./v.\n繁栄、栄える\nprosperity, prosper\nCentral Standard Note
presia	[pureshia]\nadv.\n～します様に、～どうか…して下さい\nmay it be so, would you please do ~, please ~\nMetafalss Note
prooth	[puru^su]\nn.\n血\nblood\nCult Ciel Note
pruna	[?]\nadj.\n可笑しい\nfunny\nUnknown [Unofficial]
ptrapica	[putorapika]\nn.\n宝\ntreasure\nCult Ciel Note
ptrapile	[putorapiru]\nn.\n秋\nautumn\nCult Ciel Note
pupe	[pyu^pe]\nn.\n涙\ntear, teardrop\nNew Testament of Pastalie
pyuf	[?]\nverb\n目指す \nhead for, head to \nUnknown [Unofficial]
q.g.s.	[?]\nE.v.\n終る\nend, finish\nPastalie [Unofficial]
q.l.s.	[?]\nE.v.\n激しく揺らす\nshake tremendously\nPastalie [Unofficial]
qejyu	[kejieu]\nn.\n人々、人間 (Eをつけると意訳で「恋人、妻、旦那」 YEをつけると意訳で「家族、身内」 LYEをつけると「人類皆兄弟」的な意味になる。)\npeople, humanity (Notes: Preceeded by an ""E"" emotion vowel, the meaning changes to ""lover"" and ""wife/husband"". Preceeded by an ""YE"" emotion vowel, the meaning changes to ""family, relatives, friends"". Preceeded by an ""LYE"" emotion vowel, the meaning changes to ""the grand family of humankind"".)\nNew Testament of Pastalie
qoga	[?]\nn.\n終わり、終焉\nend, ending\nUnknown [Unofficial]
qraffa	[kuraffa]\nn.\n葉\nleaf\nNew Testament of Pastalie
quals	[?]\nverb\n再生 \nrevive, resurrect \nUnknown [Unofficial]
quel	[kueru]\nE.s. II\n切に想う 必死\nearnestness, desperation\nCentral Standard Note
quen	[ku^n]\nv.\n生み出される\ngive birth, create\nCentral Standard Note
quesa	[kue^sa^]\nn.\n大地を揺らすもの、(転じて)雷鳴、稲妻\nthing that shakes the earth, thunder, lightning\nCentral Standard Note
quivale	[kuiba^re]\nn.\n冬\nwinter\nCult Ciel Note
quive	[kuuiba]\nn/v.\n沈黙 黙る 静寂\nsilence, quietness\nCult Ciel Note
quowjaz	[kuoujazu]\nn.\n正義\njustice, righteousness\nCult Ciel Note
r.f.m.	[rufun]\nE.v.\n見る\nsee, watch\nNew Testament of Pastalie
r.f.r.m.	[rufurun]\nE.v.\n認識する、知る\nknow, recognize\nNew Testament of Pastalie
r.l.t.y.	[?]\nE.v.\n甦る\nrevive, resurrect, rebirth\nPastalie [Unofficial]
r.w.	[ruu]\nE.v.\n助ける、救う\nhelp, rescue\nNew Testament of Pastalie
ra	[ra]\nE.s. III\nこのままでいたい\nI want this to last\nCentral Standard Note
race	[re^su]\nn./v.\n首飾り（巻きつける）\n(wreathe a) necklace, to wreath\nCentral Standard Note
raklya	[rakurya]\nv.\n涙する\ncry, weep\nCult Ciel Note
rana	[ra^na]\nv.\n駆ける\nrun, dash\nCentral Standard Note
rannef	[raniefu]\nn.\n謝礼\nreward\nCentral Standard Note
rasse	[rasse^]\nv.\nエールを送る\nto yell\nCentral Standard Note
raudl	[raudouru]\nn.\n姿、形、フォーム\nform, shape\nNew Testament of Pastalie
rawah	[rawa]\nn.\n花\nflower\nNew Testament of Pastalie
re	[re]\npre\n～される（受身の助詞）\n(passive verb prefix)\nCentral Standard Note
reen	[ri^n]\nv.\n聴く\nhear, listen\nCentral Standard Note
repoear	[repoea]\nn.\n感謝\nthanks, gratitude\nCentral Standard Note
reta	[reta]\npre.\nどうか～\nPlease...\nNew Testament of Pastalie
rete	[rete]\nn./v.\n忘れる、失念する、忘却\nforget, forgetfulness, oblivion\nCult Ciel Note
revatail	[re^vateiru]\nn.\nレーヴァテイル\nReyvateil (an artificial life form)\nMetafalss Note
reveris	[reberisu]\nn.\n夢魔 悪夢 迷夢\ndream demon, nightmare, delusion\nCentral Standard Note
revm	[remu]\nn.\n夢\ndream\nCentral Standard Note
ridalnae	[ridaruna^e]\nadj.\nかけがえのない\nirreplaceable\nMetafalss Note
rifaiah	[?]\nadjective, adverb\n甦りの \nborne of revival \nUnknown [Unofficial]
rifaien	[ri^faien]\nv.\n甦る\nresurrect, revive\nMetafalss Note
rinc	[?]\nv.\n同期する\nsynchronize, feel the same\nUnknown [Unofficial]
riomo	[rio^mo]\nv.\n(物、状態、状況を)与える 齎す\nto give a, to present a (thing, condition, state)\nCluster Note
rippllys	[ripurisu]\nn./v.\n返事をする、応答する、返事、応え\nreply, answer\nCentral Standard Note
riura	[?]\nnoun\n表情、顔 \nface, facial expression \nUnknown [Unofficial]
rivire	[rivire]\nn.\n川\nriver\nCentral Standard Note
riya	[?]\nn.\n誠実\nsincerity\nUnknown [Unofficial]
rol	[roru]\nconj.\n～のように\nas if, like\nCentral Standard Note
roon	[?]\nnoun\n館 \nmansion \nUnknown [Unofficial]
rooshellan	[?]\nnoun\nゆりかご \ncradle \nUnknown [Unofficial]
rosa	[rosa]\nn.\n薔薇、バラの花\nrose, rose petal\nCentral Standard Note
rre	[re]\npre\n（主語定義）\n(subject marker)\nCentral Standard Note
rudje	[rujie]\nadj./n.\n赤 赤い 紅\nred, scarlet, crimson\nCentral Standard Note
ruinie	[ruinie]\nv.\n破壊する\ndestroy\nCentral Standard Note
ruinien	[?]\nn.\n破壊\ndestruction\nUnknown [Unofficial]
rum	[?]\nn.\n炎\nflame\nUnknown [Unofficial]
ryewa	[riewa]\nadj.\n生い茂った\novergrown\nNew Testament of Pastalie
ryushe	[?]\nverb\n旅に出る \ndepart on a journey \nUnknown [Unofficial]
ryusse	[ryu^ji^]\nn.\n旅行、旅\njourney, trip\nCult Ciel Note
s.l.	[shiru]\nE.v.\n信じる\nbelieve, trust\nNew Testament of Pastalie
s.l.y.	[?]\nE.v.\n与える\ngive, award, convey\nPastalie [Unofficial]
s.n.k.k.	[sunku]\nE.v.\n芽吹く\nbud (plant)\nNew Testament of Pastalie
s.s.w.	[su^u]\nE.v.\n言う、告げる、語る\nsay, speak, inform\nNew Testament of Pastalie
sa	[sa]\nn.\n業 カルマ\nkarma\nCentral Standard Note
saash	[sa^shu]\nn.\n神\nGod, gods\nCentral Standard Note
sabl	[saburu]\nn.\n砂\nsand\nCentral Standard Note
sacra	[?]\nn.\n血\nblood\nUnknown [Unofficial]
sallogna	[saroguna]\nv.\n寝転ぶ 横たわる 横になる 横にする\nlie down, stretch, rest\nCentral Standard Note
sanctum	[sankutoumu]\nn.\n箱舟\nark\nCentral Standard Note
sar	[sa^]\nn.\n空 (語呂の問題で、同じ単語が何度も頻出してしまうため、ファンタスマゴリアのためにシュレリアが紡いだワード。)\nsky (Note: Word crafted by Shurelia for Phantasmagoria, because of the problem that represented the use of ""ciel"" given its two meanings).\nAlpha Note (EOLIA)
sara	[sara]\nn.\n草\ngrass\nCentral Standard Note
sarla	[sarura]\nn.\n詩\nsong\nMetafalss Note
sarr	[sa^ru]\nn.\n陽光、輝き\nsunlight, radiance\nNew Testament of Pastalie
sarrifis	[sarifisu]\nv.\n（生贄を）捧げる\noffer (a sacrifice)\nCentral Standard Note
sarsa	[sa^sa]\nn.\n雨\nrain\nNew Testament of Pastalie
sash	[?]\nv.\n散らす\nscatter\nUnknown [Unofficial]
sasye	[sashie]\nn.\n少女\ngirl, young woman\nCentral Standard Note
savath	[sa^basu]\nv.\nほとばしる\nsurge, gush out\nCult Ciel Note
sechel	[sekeru]\nn.\n都市\ncity\nNew Testament of Pastalie
sefanl	[sefanru]\nn.\n森\nforest\nNew Testament of Pastalie
selena	[serena]\nv.\n奏でる\nplay (a instrument)\nMetafalss Note
sephaje	[?]\nn.\n創世\ncreation of the world\nUnknown [Unofficial]
sev	[sevu]\nconj.\n～の時に\nat the time of ~, when ~\nNew Testament of Pastalie
sguela	[?]\nadjective\n大切な \nprecious, important \nUnknown [Unofficial]
shazra	[shazura]\nn.\n荊の蔓、茨、棘 (棘を持つ植物)\nthorny vine, thorn, thorny shrub (Note: Used only for plants that have thorns)\nCentral Standard Note
sheak	[shieaku]\nn.\n太陽\nsun\nCult Ciel Note
sheaken	[?]\nn.\n左\nleft\nUnknown [Unofficial]
shefra	[?]\nn.\n創世\ncreation of the world\nUnknown [Unofficial]
shell	[?]\nn.\n殻（の中）\n(inside a) shell\nUnknown [Unofficial]
shellan	[shieran]\nn.\n鳥かご、籠、檻、ケージ\nbirdcage, cage, basket, pen\nMetafalss Note
shen	[shien]\nn.\n光\nlight\nCentral Standard Note
shyun	[?]\nadjective, noun\n哀しみ \nsadness, grief \nUnknown [Unofficial]
sial	[sharu]\nadj.\n少しの、ちょっとの\na bit, a little\nCentral Standard Note
siance	[shanshie]\nn.\n聖域、尊い場所、理想郷\nholy land, sanctuary, utopia\nNew Testament of Pastalie
siann	[shan]\nn.\n光 (LYAをつけると意訳で「焔の御子」)\nlight (Note: if it's preceeded by a ""LYA"" emotion vowel, its meaning changes to ""Maiden of Homura"")\nNew Testament of Pastalie
sielp	[shierupu]\nn.\nせせらぎ\nbrook, murmur\nCentral Standard Note
sik	[shiku]\nv.\n離れる\nleave, move away from\nCult Ciel Note
siss	[?]\nv.\n消す\nerase, put out, eliminate\nUnknown [Unofficial]
skit	[sukitto]\nv.\n約束する\npromise\nCult Ciel Note
slep	[surepu]\nv.\n眠る\nsleep\nCentral Standard Note
slepir	[surepia]\nv.\n眠らせる、(活動を)停止させる\nput to sleep, stop (an activity)\nMetafalss Note
so	[?]\nconj.\nそんなに、それほど\nin such a way, so much\nUnknown [Unofficial]
soare	[?]\nn.\n詩, 祈り\nsong, prayer\nUnknown [Unofficial]
sol	[soru]\nv.\n（日の光が）輝く、燦々と照りつける (ただし、sol cielという熟語でこの世界「ソル・シエール」を指す。ただし標準律では世界を指すときに「ar ciel」といい、「sol ciel」とは言わない。この世界をsol cielと言うのはあくまで古メタファルス律のみ。)\n(daylight) shines, shine down brilliantly (Note: However, the phrase ""Sol Ciel"" refers to the region of the first Ar tonelico tower, and was to be used as the name of the world. It's because there was already a phrase in Central Standard Note for this world, ""Ar Ciel"", that ""Sol Ciel"" ended becoming only the name of the region of the first tower. That region owes its name to the Ancient Metafalss Note.)\nMetafalss Note
sonwe	[son'ue]\nv.\n歌う\nsing\nMetafalss Note
sor	[soa]\npro.\nそれ\nthat\nCentral Standard Note
sorr it	\nconj.\nそれ\nit's that way\n
sorra it	\nconj.\nそれ?牢獄?\nin those ways,\n
sos	[sosu]\nconj.\n～ために\nfor, because of, for the sake of\nCentral Standard Note
sosar	[sosaru]\nn.\n魔術、魔力 (mayaという魔法を現すヒュムノス語もありますが、そちらよりも、より呪文に特化したイメージです。(mayaは神秘的なニュアンスを含んだ言葉。maya=ミラクル。sosar=ソーサリー…みたいな位置づけ。)\nmagic, magical power (Note: Even if the magic that manifests through Hymmnos is called ""maya"", actually the spells have a much more specialized image. ""maya"" has a nuance of miracles made by the power of the gods, while sosar... its more similar to standard sorcery).\nCentral Standard Note
sphaela	[sufaiera]\nn.\n世界\nworld\nNew Testament of Pastalie
sphilar	[sufi^ra]\nn.\n精神、心\nmind, spirit\nMetafalss Note
spiritum	[supiritoumu]\nadj./n.\n魂 魂の\nsoul, of the soul\nCentral Standard Note
spitze	[shupittsue]\nn.\n自由\nfreedom\nCentral Standard Note
ssvid	[?]\nv.\n生き凌ぐ\noutlive\nUnknown [Unofficial]
stel	[suteru]\nv.\n取る、奪う、盗む (強引に取る場合。負の行動としての取る。)\ntake, steal, snatch away (Note: Used when one takes something from other person by force. Used usually by the one that lost the stolen thing)\nCentral Standard Note
stelled	[suteredo]\nv.\n取り合う、奪い合う (強引に取り合う場合。負の行動としての取る。)\ncompete, struggle for (Note: Used for fierce battles or competitions. Used usually by the loser.)\nCentral Standard Note
suwant	[suwanto]\nv.\n救う、助ける\nsave, rescue, help\nCentral Standard Note
swant	\nv.\n助ける、救う\nhelp, save, rescue\nCentral
syalea	[?]\nn.\n決意\ndecision, resolve\nUnknown [Unofficial]
syana	[?]\nnoun, verb\n木霊、木霊する \necho, resound \nUnknown [Unofficial]
syast	[shasuto]\nv.\n集う、集結する\ncongregate, gather\nCentral Standard Note
syec	[seku]\nn.\n深淵、深いところ (物理的ではない、主に「心」やメンタル、精神世界の表現語として使う。)\nabyss, depths (Note: Not used to refer to a physical abyss, but rather to a mental one. This word is usually used to represent the Soulspace).\nCult Ciel Note
syezo	[?]\nnoun\nスープ \nsoup \nUnknown [Unofficial]
synk	[shinku]\nv.\n重なる\noverlap, pile up\nCentral Standard Note
syunaht	[shunatto]\nverb\n消え去る、消し飛ぶ \ndissolve, scatter, vanish \nCult Ciel Note
t.h.s.	[?]\nE.v.\n外に出る\ngo outside\nPastalie [Unofficial]
t.k.d.	[tokuto]\nv.\n届く\nreach\nNew Testament of Pastalie
t.n.	[toun]\nv.\n止める、やめる\nstop, end\nNew Testament of Pastalie
t.n.m.n.	[tonmun]\nv.\n(種を)まく、植える\nscatter (seeds), (to) plant\nNew Testament of Pastalie
t.r.m.	[torumu]\nv.\n展開する、咲かせる、実現する\ndevelop, make bloom, realize\nNew Testament of Pastalie
tafane	[?]\nadj.\n輝く\nglittering, sparkling\nPastalie [Unofficial]
talam	[ta^ran]\nadj.\n東雲色\ndawn's color\nNew Testament of Pastalie
tanta	[tanta]\nv.\n舞う\ndance\nCentral Standard Note
tapa	[tapa]\nn.\n水\nwater\nNew Testament of Pastalie
tarfe	[ta^fe]\nv.\n止まる、留まる\nstop, halt\nCentral Standard Note
targue	[ta^gue]\nconj.\nたとえ～だとしても\neven if ~ is the case\nNew Testament of Pastalie
tasyue	[ta^shue]\nv.\n捧げる\noffer, sacrifice\nMetafalss Note
tatakaria	[?]\nnoun\n命たち、全ての命 \nexistences, beings, lives \nUnknown [Unofficial]
tek	[teku]\nv.\n行く\nGo\nCentral Standard Note
tes	[tesu]\nconj.\n～に、～へ\nat ~, to ~\nCentral Standard Note
teyys	[teisu]\nv.\n留まる、残る、居る、居座る (英語のstayと同義)\nhalt, remain, exist, stay (Note: Equivalent to the English ""stay"")\nCentral Standard Note
ther	[jia]\nconj.\nあれ、あの\nthat\nCentral Standard Note
tictim	[teikuteimu]\nv.\n操る、操作する、意のままにする\ncontrol, operate, do as one pleases\nCentral Standard Note
tie	[teie]\nconj.\n～に対して（対象を特定・指定する）\nin regards to... (specifying a subject)\nNew Testament of Pastalie
tienar	[?]\nadverb\n止まらない \nwithout stopping, without end \nUnknown [Unofficial]
tilanta	[?]\nverb\n流れこむ \nflow into \nUnknown [Unofficial]
tim	[?]\nn.\n時\ntime\nUnknown [Unofficial]
titia	[teiteia]\nn.\n善意、善性\ngood will, innate goodness of man\nNew Testament of Pastalie
titil	[teiteiru]\nn.\n小物\nsmall things, accesories\nCult Ciel Note
titilia	[teiteiria]\nadj.\n小さい\nsmall, little, tiny\nCult Ciel Note
toe	[?]\nadjective, verb\n? \nrise above, stand over \nUnknown [Unofficial]
tonelico	[?]\nn.\n神木\ndivine tree, (possible alternate meaning: tower)\nUnknown [Unofficial]
tou	[tou]\nconj.\n～に\nat ~, in ~, to ~\nCentral Standard Note
touwaka	[touwaka]\nE.s. II\n心に希望を秘める 望む（第Ⅱ想音）\nwishful, hiding wishes in my heart\nCentral Standard Note
trina	[?]\nverb\n気づいて \nnotice, become aware \nUnknown [Unofficial]
ttu	[tsutou]\nconj.\n～するために\nin order to do ~\nNew Testament of Pastalie
ture	[?]\nn.\n絆\nbonds\nUnknown [Unofficial]
tussu	[toussu]\nn.\n変化\nchange\nNew Testament of Pastalie
tyui	[touyui]\nadj.\n小さな\nSmall, little, tiny\nNew Testament of Pastalie
tyuss	[?]\nadj.\n優しい\ntender, kind\nPastalie [Unofficial]
ugi	[u^ji]\nv.\n決める\ndecide\nCult Ciel Note
uje	[?]\nadj.\n残酷\ncruel, evil\nUnknown [Unofficial]
ujes	[ujiesu]\nn.\n悪意\nill will\nNew Testament of Pastalie
unloee	[anroi]\nv.\n平伏す\nprostrate before\nCentral Standard Note
urgn	[urugun]\nn.\n嘆き\ngrief, lamentation\nNew Testament of Pastalie
urr	[uru]\nv.\n(見えなかったものが)顕れる、体現(する)、具現化(する)\n(something unseen) appears, manifests, incarnates\nCentral Standard Note
ut	[utou]\nconj.\n～に、～へ (to)\nat ~, to ~ (Note: Equivalent to the English ""to"")\nNew Testament of Pastalie
uteu	[uteu]\nv.\nまどろむ\ndoze off\nCult Ciel Note
v.a.	[va]\nv.\n生む、紡ぐ\nproduce, craft\nNew Testament of Pastalie
v.s.k.	[visuku]\nv.\n体感する、実感する。経験する\nsense physically, feel, experience\nNew Testament of Pastalie
v.t.	[vutsu]\nv.\n生きる\nlive\nNew Testament of Pastalie
vaffa	[?]\nverb\n掃う \nclear away, sweep away \nUnknown [Unofficial]
vale	[?]\nnoun\nベッド \nbed \nUnknown [Unofficial]
valwa	[baruwa]\nv.\n浄化する\npurify\nCentral Standard Note
vamue	\n\n\n(unknown meaning)\n
van	[van]\nconj.\n～であっても、しようとも\neven if ~, even should ~ happen\nMetafalss Note
varda	[varuda]\nn.\n大樹\nbig tree\nMetafalss Note
vega	[vega]\nn.\nここ、この\nhere, this\nNew Testament of Pastalie
vege	[vejie]\nn.\nそこ、その\nthere, that\nNew Testament of Pastalie
vianchiel	[vianshie^ru]\nn./adj.\n無垢の、穢れなき、清らかな、美しい\npure, undefiled, clean, beautiful\nMetafalss Note
viega	[vie^ga]\nn.\n刃、剣\nblade, sword\nMetafalss Note
vigiga	[?]\nadjective, noun\n冷たく \ncold \nUnknown [Unofficial]
vinan	[vinan]\nn./adj.\n白, 白い\nwhite\nCentral Standard Note
vine	[vi^ne]\nn.\n酒・果実酒・葡萄酒 (酒精の代名詞)\nalcohol, liquor, wine (Note: general pronoun for alcoholic beverages)\nCentral Standard Note
viss	[visu]\nv.\n読む、読み取る\nread, read between the lines\nCentral Standard Note
vit	[vitto]\nv.\n見る\nsee, watch\nCult Ciel Note
viuy	[?]\nadj.\n暗く翳した\ndarkened\nUnknown [Unofficial]
vl	[?]\nconj.\n～から, ～に\nsince, from, in\nUnknown [Unofficial]
vonn	[von]\nn./adj.\n闇\ndark, darkness\nCentral Standard Note
w.f.	[ufu]\nv.\n～したい\nwant to do ~\nNew Testament of Pastalie
w.h.h.	[wou]\nv.\n感じる\nfeel, sense\nNew Testament of Pastalie
w.n.s.	[unsu]\nv.\n訪れる, 響く\nvisit, echo\nNew Testament of Pastalie
w.r.l.	[ururu]\nv.\n目指す\naim at, have an eye on\nNew Testament of Pastalie
w.r.m.	[warumu]\nv.\n照らす\nshine on, illuminate\nNew Testament of Pastalie
w.s.	[usu]\nv.\n与える\ngive\nNew Testament of Pastalie
w.s.s.	[?]\nv.\n讃える\npraise\nPastalie [Unofficial]
w.w.j.n.c.	[u^janku]\nv.\n共鳴する\nresound, sympathize\nNew Testament of Pastalie
wa	[wa]\nE.S.III\nどちらでもない 今、有るがままの状況を受け入れる（第Ⅲ想音）\nit doesn't matter - I will accept things the way they are now\nCentral Standard Note
waa	[waa]\nE.S.II\n嬉しい(第Ⅱ想音)\nhappy\nMetafalss Note
waath	[wa^su]\nv.\n再生する\nrevive, rebirth\nCentral Standard Note
waats	[wa^tsu]\nadj.\n大切な\nimportant\nCentral Standard Note
wael	[wae^ru]\nn./v.\n喜び\njoy, delight\nCentral Standard Note
walaen	[waraen]\nn.\n人生\n(human) life\nCult Ciel Note
walaka	[waraka]\nv.\n歩く\nwalk\nCentral Standard Note
walasye	[wara^shie]\nn.\n人間\nhuman, people\nCult Ciel Note
walphish	[warufisshu]\nn.\n人魚 (第一紀に海に住んでいた神)\nmermaid, merman (Note: A god/dess that used to live in the oceans during the First Era)\nCult Ciel Note
warce	[wa^shie]\nv./n.\n祝福(する)、祝い\nbless(ing), celebration\nCentral Standard Note
ware	[wa^re]\nconj.\n～の時に、～の中で\nduring ~, in the middle of ~\nCentral Standard Note
warma	[wa^ma]\nadj.\n温かい\nwarm\nCentral Standard Note
wart	[wa^to]\nn.\n言葉\nword\nCentral Standard Note
wasara	[wasara]\nadj./n.\n豊か\nabundant, abundance\nCentral Standard Note
wase	[ueizu]\nadj./n.\n強烈な\nstrong, intense\nCult Ciel Note
wassa	[wassa]\nn.\n祭典\nfestival, feast\nCult Ciel Note
wassee	[?]\nv.\n讃える\npraise\nUnknown [Unofficial]
watt	[watto]\nv.\nびっくりする\nsurprise, scare\nCult Ciel Note
waze	[?]\nconj.\n多\ntoo much\nUnknown [Unofficial]
we	[ue]\nconj.\n～よりも\neven more than ~\nCentral Standard Note
weak	[uiaku]\nn.\n月\nmoon\nCentral Standard Note
weaken	[?]\nn.\n右\nright\nUnknown [Unofficial]
weal	[?]\nadj./E. s. II\n喜び\nhappy, glad\nUnknown [Unofficial]
wearequewie	[wa^rekuwaie]\nv.\n望む、願う、希望する\nwish, desire, pray, request for, hope for\nMetafalss Note
weel	[ui^]\nv.\n叶って！\nCome true!, Be realized!\nCentral Standard Note
ween	[uin]\nconj.\n～の中に、中で（状態を表す助詞） (英語のinと同義（文脈によっては必ずしも必要ではない）)\ninside of ~, in ~ (particle to indicate current condition) (Note: Equivalent to the English ""in"", though it's not always necessary, depending on the context)\nCentral Standard Note
wefa	[?]\nadj.\n暖かな\nwarm, mild\nPastalie [Unofficial]
werllra	[uirura]\nn.\n涙、雫\ntear, drop\nMetafalss Note
werlwe	[uiruue]\nv.\n泣く、涙する\ncry, shed tears\nMetafalss Note
whai	[fai]\nconj.\nなぜ～ なのだろう\nwhy\nCentral Standard Note
whalt	[?]\nconj.\n何\nwhat\nUnknown [Unofficial]
wharn	[wa^n]\nn.\n腕\narm\nCentral Standard Note
whou	[fou]\nconj.\n～する者\nwho, person who ~\nCentral Standard Note
wi	[ui]\nconj.\nその、そこの\nthat, the one there\nCentral Standard Note
wiaa	\n\n\n(unknown meaning)\n
wiene	[?]\nn.\n音色\nmelody, tone, timbre\nUnknown [Unofficial]
willie	[uiri]\nadj.\n弱い、儚い\nweak, transient\nCentral Standard Note
wim	[uimu]\nn.\n娘\ngirl, daughter\nCentral Standard Note
windiling	[?]\nn.\n風の精\nspirit of the wind\nUnknown [Unofficial]
wirtamarls	[?]\nadjective, noun\n静か \ntranquil, tranquility \nUnknown [Unofficial]
wis	[visu]\nv.\n～である\nbe, is\nMetafalss Note
wol	[voru]\nE.S.II\n猛進、熱血（第Ⅱ想音）\nfervor, rush\nCentral Standard Note
won	[uon]\nconj.\n～の上（表面）に（状態を表す助詞） (英語のonと同義)\nabove (on the surface) of ~ (particle to indicate current condition) (Note: Equivalent to the English ""on"")\nCentral Standard Note
x.	[zu]\nE.v.\n(主語動詞)\n(subject marker)\nNew Testament of Pastalie
x.y.n.	[?]\nE.v.\n傷つく\nhurt, injure\nPastalie [Unofficial]
xava	[?]\nn.\n傷\nwound\nUnknown [Unofficial]
xe	[ji]\nconj./v.\n給え (より塔に尊敬の感情を明確に伝えたい場合に使用する。 例：xe khal(護り給え) あまり常用される単語ではない。)\nplease (used before a verb), bestow, grant, receive (Note: Used when someone wants to state a feeling of great respect for the tower. Example: xe khal (please, protect me) It's not a daily used word)\nCluster Note
xel	[?]\nconj.\n～から（時間）\nsince ~ (time)\nUnknown [Unofficial]
xest	[zesuto]\nv.\n変換する\nchange, transform\nCult Ciel Note
xevxl	[?]\nn.\n絶望\ndespair\nUnknown [Unofficial]
xl	[kuseru]\nconj.\n～の時から\never since ~\nCentral Standard Note
xorg	[?]\nadj.\n傲慢な\nproud\nUnknown [Unofficial]
y.m.q.	[yanku]\nv.\n実る\nbear fruit, ripen\nNew Testament of Pastalie
y.y.	[yaya]\nv.\n癒す\nheal, cure\nNew Testament of Pastalie
y.z.t.	[yazutto]\nv.\n願う\nwish, desire, request\nNew Testament of Pastalie
yaha	[yaha]\nv.\n笑う\nlaugh, smile\nCentral Standard Note
yanje	[yanie]\nadv.\nずっと、永遠に\nforever, eternally\nCentral Standard Note
yant	[yanto]\nE.s.II\n恐慌状態（第Ⅱ想音）\nfrightened, scared\nMetafalss Note
yanwe	[yan'ue]\nv.\n大事にする\ntreat with care\nCentral Standard Note
yanyaue	[yanyaue]\nadj.\n大切な\nimportant, valuable\nMetafalss Note
yart	[ya^to]\nv.\n出逢う\nmeet (by chance), come across\nCentral Standard Note
yaserwe	[yasa^ue]\nv.\nリラックスする、安らぐ\nrelax, feel at ease\nCentral Standard Note
yasra	[yasura]\nadj.\n優しい、穏やか\ngentle, kind, calm, quiet\nMetafalss Note
yassa	[yassa]\nv.\nクリアする、達成する\nclear, achieve\nCentral Standard Note
yatse	[yasse]\nv.\n（肯定的な感情を）与える\ngive (positive emotions)\nCentral Standard Note
yea	[iea]\nE.s.II\n嬉しい（第Ⅱ想音）\nhappy\nCentral Standard Note
yeal	[ie^a]\nn.\n線、紐\nline, beam, wire, string\nCult Ciel Note
yeeel	[ie^ru]\nadj.\n遠い\nfar, distant\nCult Ciel Note
yehah	[ieha^]\nn.\n幸せ\nhappiness, good fortune\nCentral Standard Note
yehar	[ieha^ru]\nv.\n解放する、解き放つ\ndeallocate, unleash, release\nMetafalss Note
yerwe	[ie^ue]\nv.\n鳴く\nchirp, bark, purr\nMetafalss Note
yesse	[?]\nverb\n育む \nrear, raise \nUnknown [Unofficial]
yetere	[ie^tere]\nadv.\nそうすれば～\nif so, in that case\nCentral Standard Note
yor	[yoa]\nn.\nあなた\nyou (object)\nCentral Standard Note
yora	[yora]\nn.\nあなたたち\nyou (plural object)\nCentral Standard Note
yorr	[yoruru]\nn.\nあなた（主語定義）\nyou (subject)\nCentral Standard Note
yorra	[yorurura]\nn.\nあなたたち（主語定義）\nyou (plural subject)\nCentral Standard Note
yos	[yosu]\nadv.\n貴方が、貴方の\nyour, yours\nCentral Standard Note
yosyua	[yoshua]\nv.\n～を慰める\ncomfort, console, amuse\nCentral Standard Note
yuez	[yueze]\nadv.\n互いに\nmutually, reciprocally\nCentral Standard Note
yulun	[?]\nverb\nとかす \ndissolve, homogenise \nUnknown [Unofficial]
yura	[yura]\nn.\n力のバランス\nbalance of power\nCentral Standard Note
z.z.x.	[zui^kusu]\nv.\n絶望する\n(to) despair\nNew Testament of Pastalie
zaam	[?]\nnoun\n海原 \nsea, ocean \nUnknown [Unofficial]
zadius	[zadeiusu]\nn.\n憎悪\nhatred\nMetafalss Note
zaffur	[?]\nv.\n対抗、あがき\nstruggle, oppose\nUnknown [Unofficial]
zahha	[zahha]\nv.\n進む、進行 (騎士隊のように、大勢で行軍するときに用いる。勇敢な様。)\nadvance, improve (Note: Used for the marching of a great number of people, such as knight company. Has heroic connotations).\nCult Ciel Note
zalez	[za^rezu]\nn.\n滝\nwaterfall\nNew Testament of Pastalie
zarle	[za^ru]\nv.\n(雨が)降る、降り注ぐ\nfall (rain), downpour\nCentral Standard Note
zarnn	[?]\nn.\n嵐\nstorm, tempest\nUnknown [Unofficial]
zash	[zasshu]\nadj./n.\n痛い、苦痛\npainful, pain, agony\nCentral Standard Note
zassyen	[zasshien]\nv.\n泳ぐ\nswim\nCentral Standard Note
zauve	[za^be]\nn./adj.\n怜悧な\nclever, sagacious\nCult Ciel Note
zeeth	[ji^zu]\nn.\n鎖\nchain, chains\nCentral Standard Note
zenva	[tsuenva]\nv.\n飛び越える、超越する\njump over, clear, transcend\nCentral Standard Note
zess	[zesu]\nadv.\n～ように\nlike ~\nNew Testament of Pastalie
zethpa	[zesupa]\nv.\n斬りつける\ncut, slash\nCentral Standard Note
zetsfy	[zettsufai]\nn.\n残酷\ncruelty, harshness\nCult Ciel Note
zixxa	[?]\nnoun\n意地 \nattitude, disposition, spirit \nUnknown [Unofficial]
zodal	[zodaru]\nn./v.\n死せる、死の\ndeath, die, of death\nMetafalss Note
zodaw	[zodau]\nn.\n死\ndeath\nMetafalss Note
zuieg	[zuui^gu]\nn./adj.\n権力、権限\n(political) power, authority, influence\nAlpha Note (EOLIA)
zweie	[tsuvaie]\nE.s.II\n決意を心に秘める 真摯（第Ⅱ想音）\nhiding determination in the heart, sincerity, earnestness\nCentral Standard Note
zwihander	[tsuvaihenderu]\nn./v.\n勝利(する)、勝ち\nsuccess, win, triumph, victory\nCentral Standard Note
zz	[zu^]\nadv.\n否定\nnegation, denial, un-\nNew Testament of Pastalie
