-	\n▪<i><font face='mono'>enter</font></i>\n～に入り込む | enter ~\n\n<b>&lt;DIALECT&gt;</b> Central\n
0	[neru/o]\n▪<i><font face='mono'>adjective</font></i>\n0: <i><font color='#404040'>Rrha ki ra echcrra li 0 Rrha ki ra chs maxim&nbsp;&nbsp;—<font size='1'>EXEC_METAFALICA/.</font></font></i>\n\n<b>&lt;DIALECT&gt;</b> Central Standard Note\n
1	[noi/i]\n▪<i><font face='mono'>adjective</font></i>\n1: <i><font color='#404040'>fulual 1 dornpica art 1 walasye enne&nbsp;&nbsp;—<font size='1'>EXEC_HIBERNATION/.</font></font></i>\n\n<b>&lt;DIALECT&gt;</b> Central Standard Note\n
10	[deku/de]\n▪<i><font face='mono'>adjective</font></i>\n10: <i><font color='#404040'>En 10 dyyal nuih bexm&nbsp;&nbsp;—<font size='1'>EXEC_HIBERNATION/.</font></font></i>\n\n<b>&lt;DIALECT&gt;</b> Central Standard Note\n
100	[heku/he^]\n▪<i><font face='mono'>adjective</font></i>\n100: <i><font color='#404040'>En 100 dyyal nuih bexm&nbsp;&nbsp;—<font size='1'>EXEC_HIBERNATION/.</font></font></i>\n\n<b>&lt;DIALECT&gt;</b> Central Standard Note\n
1000	[kiku/kii]\n▪<i><font face='mono'>adjective</font></i>\n1000: <i><font color='#404040'>En 1000 dyyal nuih bexm&nbsp;&nbsp;—<font size='1'>EXEC_HIBERNATION/.</font></font></i>\n\n<b>&lt;DIALECT&gt;</b> Central Standard Note\n
10000	[miku/mii]\n▪<i><font face='mono'>adjective</font></i>\n10000\n\n<b>&lt;DIALECT&gt;</b> Central Standard Note\n
2	[ji]\n▪<i><font face='mono'>adjective</font></i>\n2: <i><font color='#404040'>En 2 dyyal nuih bexm&nbsp;&nbsp;—<font size='1'>EXEC_HIBERNATION/.</font></font></i>\n\n<b>&lt;DIALECT&gt;</b> Central Standard Note\n
3	[dori]\n▪<i><font face='mono'>adjective</font></i>\n3: <i><font color='#404040'>En 3 dyyal nuih bexm&nbsp;&nbsp;—<font size='1'>EXEC_HIBERNATION/.</font></font></i>\n\n<b>&lt;DIALECT&gt;</b> Central Standard Note\n
4	[fefu]\n▪<i><font face='mono'>adjective</font></i>\n4: <i><font color='#404040'>En 4 dyyal nuih bexm&nbsp;&nbsp;—<font size='1'>EXEC_HIBERNATION/.</font></font></i>\n\n<b>&lt;DIALECT&gt;</b> Central Standard Note\n
5	[vira]\n▪<i><font face='mono'>adjective</font></i>\n5: <i><font color='#404040'>En 5 dyyal nuih bexm&nbsp;&nbsp;—<font size='1'>EXEC_HIBERNATION/.</font></font></i>\n\n<b>&lt;DIALECT&gt;</b> Central Standard Note\n
6	[ikusa]\n▪<i><font face='mono'>adjective</font></i>\n6: <i><font color='#404040'>En 6 dyyal nuih bexm&nbsp;&nbsp;—<font size='1'>EXEC_HIBERNATION/.</font></font></i>\n\n<b>&lt;DIALECT&gt;</b> Central Standard Note\n
7	[heputo]\n▪<i><font face='mono'>adjective</font></i>\n7: <i><font color='#404040'>En 7 dyyal nuih bexm&nbsp;&nbsp;—<font size='1'>EXEC_HIBERNATION/.</font></font></i>\n\n<b>&lt;DIALECT&gt;</b> Central Standard Note\n
8	[okuta]\n▪<i><font face='mono'>adjective</font></i>\n8: <i><font color='#404040'>En 8 dyyal nuih bexm&nbsp;&nbsp;—<font size='1'>EXEC_HIBERNATION/.</font></font></i>\n\n<b>&lt;DIALECT&gt;</b> Central Standard Note\n
9	[nei]\n▪<i><font face='mono'>adjective</font></i>\n9: <i><font color='#404040'>En 9 dyyal nuih bexm&nbsp;&nbsp;—<font size='1'>EXEC_HIBERNATION/.</font></font></i>\n\n<b>&lt;DIALECT&gt;</b> Central Standard Note\n
<-x	[(su)pagu]\n▪<i><font face='mono'>language construct</font></i>\n(anaphor indicator) \n\n<b>&lt;DIALECT&gt;</b> New Testament of Pastalie\n
>>	\n▪<i><font face='mono'>language construct</font></i>\nTras: <i><font color='#404040'>Rrha ki ra nha-HYMMNOS1x01 >> pat mea en xest SOL=MARTA > A2&nbsp;&nbsp;—<font size='1'>EXEC_SOL=FAGE/.</font></font></i>\n\n<b>&lt;DIALECT&gt;</b> Central\n
ADDR	[?]\n▪<i><font face='mono'>language construct</font></i>\naddress designation \n\n<b>&lt;DIALECT&gt;</b> Unknown [Unofficial]\n
Chronicle Key	\n▪<i><font face='mono'>n.</font></i>\nChronicle Key (a hymn)\n\n<b>&lt;DIALECT&gt;</b> Alpha (Eolia)\n
D_CELL	[D serofan]\n▪<i><font face='mono'>language construct</font></i>\nD-Cellophane \n\n<b>&lt;DIALECT&gt;</b> Unknown [Unofficial]\n
Despedia	\n▪<i><font face='mono'>n.</font></i>\nDespedia (a hymn)\n\n<b>&lt;DIALECT&gt;</b> \n
Dia	[dia]\n▪<i><font face='mono'>n.</font></i>\nking, throne, ruler: <i><font color='#404040'>Hyear Ma num ra gyusya yorr ee Dia oz ruinien&nbsp;&nbsp;—<font size='1'>EXEC_DESPEDIA/.</font></font></i>\n\n<b>&lt;DIALECT&gt;</b> Central Standard Note\n
EXA_PICO	[ekusapi^ko]\n▪<i><font face='mono'>noun</font></i>\nExa Pico \n\n<b>&lt;DIALECT&gt;</b> Unknown [Unofficial]\n
Fou	[fou]\n▪<i><font face='mono'>E.s. I</font></i>\nA little: <i><font color='#404040'>Fou hellei ga&nbsp;&nbsp;—<font size='1'>EXEC_HARMONIOUS_FUSION/.</font></font></i>\n\n<b>&lt;DIALECT&gt;</b> Central Standard Note\n
Haibanation	[haiba^neshon]\n▪<i><font face='mono'>n.</font></i>\nHibernation (a hymn)\n\n<b>&lt;DIALECT&gt;</b> Unknown [Unofficial]\n
Harmonius	\n▪<i><font face='mono'>n.</font></i>\nHarmonious (a hymn)\n\n<b>&lt;DIALECT&gt;</b> Central\n
Implanta	[imupuranta]\n▪<i><font face='mono'>n.</font></i>\nImplanta (a hymn); God's Tree in the myths of Metafalss, fruit, seed: <i><font color='#404040'>x. sorr a.u.k. mutrk rhaplanca en Implanta&nbsp;&nbsp;—<font size='1'>METHOD_METAFALICA/.</font></font></i>\n\n<b>&lt;DIALECT&gt;</b> Unknown [Unofficial]\n
Linca	[rinka]\n▪<i><font face='mono'>n.</font></i>\nLinker (a hymn)\n\n<b>&lt;DIALECT&gt;</b> Central Standard Note\n
Ma	[ma]\n▪<i><font face='mono'>E.s. I</font></i>\npresence of mind: <i><font color='#404040'>Ma ki ga ks maya yor syec&nbsp;&nbsp;—<font size='1'>Singing Hill</font></font></i>\n\n<b>&lt;DIALECT&gt;</b> Central Standard Note\n
Manac	[manaku]\n▪<i><font face='mono'>n.</font></i>\ntrue name, name of soul: <i><font color='#404040'>knawa Manac yor Manac&nbsp;&nbsp;—<font size='1'>EXEC_DESPEDIA/.</font></font></i>\n\n<b>&lt;DIALECT&gt;</b> Cult Ciel Note\n
Maoh	\n▪<i><font face='mono'>n.</font></i>\nRhaplanca's partner in the myths of Metafalss.\n\n<b>&lt;DIALECT&gt;</b> Ancient Metafalss\n
Meta	[?]\n▪<i><font face='mono'>noun</font></i>\nMid-sized mountainous region \n\n<b>&lt;DIALECT&gt;</b> Unknown [Unofficial]\n
Metafalica	[metafarika]\n▪<i><font face='mono'>n.</font></i>\nMetafalica (a hymn), Song of Hope (to Mir), Song of Creation, Utopia: <i><font color='#404040'>Faura selena anw Metafalica&nbsp;&nbsp;—<font size='1'>EXEC_HARMONIOUS</font></font></i>\n\n<b>&lt;DIALECT&gt;</b> Metafalss Note\n
Nn	[n]\n▪<i><font face='mono'>E.s. I</font></i>\nlethargy: <i><font color='#404040'>Nn i ga exec hymme METAFALICA >> SOL=FAGE/1x10 enter FRELIA&nbsp;&nbsp;—<font size='1'>EXEC_METAFALICA/.</font></font></i>\n\n<b>&lt;DIALECT&gt;</b> Central Standard Note\n
Paja	[pa^ja]\n▪<i><font face='mono'>n.</font></i>\nPurger (a hymn)\n\n<b>&lt;DIALECT&gt;</b> Central Standard Note\n
Phantasmagoria	[fantasumagoria]\n▪<i><font face='mono'>n.</font></i>\nPhantasmagoria (a hymn)\n\n<b>&lt;DIALECT&gt;</b> Alpha Note (EOLIA)\n
Re=Nation	[rineishon]\n▪<i><font face='mono'>n.</font></i>\nRe-Nation (a hymn)\n\n<b>&lt;DIALECT&gt;</b> Central Standard Note\n
Replekia	\n▪<i><font face='mono'>n.</font></i>\nReplakia (a hymn)\n\n<b>&lt;DIALECT&gt;</b> \n
Rhaplanca	\n▪<i><font face='mono'>n.</font></i>\na goddess from Meta Falss' mythology, and Maoh's partner: <i><font color='#404040'>Rhaplanca selena phira&nbsp;&nbsp;—<font size='1'>EXEC_METAFALICA/.</font></font></i>\n\n<b>&lt;DIALECT&gt;</b> Ancient Metafalss\n
Rig=Veda	[riguve^da]\n▪<i><font face='mono'>n.</font></i>\nRigveda (a hymn)\n\n<b>&lt;DIALECT&gt;</b> Metafalss Note\n
Rrha	[ra]\n▪<i><font face='mono'>E.s. I</font></i>\ntrance state (Note: Used only for a trance state in which the emotions of the singer aren't really expressed. Naturally, when this emotion sound is used, it doesn't show the same calm and composure of the other emotion sounds, and it flows by itself from the mouth of the singer): <i><font color='#404040'>Rrha yea ra rinc en echrra yor rre walasye jyel got ieeya&nbsp;&nbsp;—<font size='1'>Singing Hill - Harmonics FRELIA </font></font></i>\n\n<b>&lt;DIALECT&gt;</b> Central Standard Note\n
Sol=Fage	\n▪<i><font face='mono'>n.</font></i>\nSolfege (a hymn)\n\n<b>&lt;DIALECT&gt;</b> \n
Sphilia	\n▪<i><font face='mono'>n.</font></i>\nSphilia (a hymn)\n\n<b>&lt;DIALECT&gt;</b> \n
Sublimation	\n▪<i><font face='mono'>n.</font></i>\nSublimation (a hymn), sublimation (as in disappear)\n\n<b>&lt;DIALECT&gt;</b> \n
Suspend	[sasupendo]\n▪<i><font face='mono'>n.</font></i>\nSuspend (a hymn)\n\n<b>&lt;DIALECT&gt;</b> Central Standard Note\n
U-TA	[?]\n▪<i><font face='mono'>noun</font></i>\nsong \n\n<b>&lt;DIALECT&gt;</b> Unknown [Unofficial]\n
VIENA	\n▪<i><font face='mono'>n.</font></i>\nViena (a hymn): <i><font color='#404040'>Wee yea ra exec hymme VIENA >> SOL=FAGE/1x10 enter FRELIA&nbsp;&nbsp;—<font size='1'>EXEC_VIENA/.</font></font></i>\n\n<b>&lt;DIALECT&gt;</b> \n
Was	[wasu]\n▪<i><font face='mono'>E.S.I</font></i>\nvery intensely: <i><font color='#404040'>Was yea ra hymme dilete yor enter ar ciel yehar&nbsp;&nbsp;—<font size='1'>Singing Hill - Harmonics FRELIA </font></font></i>\n\n<b>&lt;DIALECT&gt;</b> Central Standard Note\n
Wee	[ui]\n▪<i><font face='mono'>E.S.I</font></i>\nfairly: <i><font color='#404040'>Wee ki ra ene rre sor hymme ar ciel en rre hymmnos ee powel&nbsp;&nbsp;—<font size='1'>Singing Hill - Harmonics FRELIA </font></font></i>\n\n<b>&lt;DIALECT&gt;</b> Central Standard Note\n
a.u.k.	[auku]\n▪<i><font face='mono'>E.v.</font></i>\nbe: <i><font color='#404040'>x. rre omness a.u.k. zodaw ess rudje noglle doodu&nbsp;&nbsp;—<font size='1'>EXEC_over.METHOD_SUBLIMATION/.~lamenza</font></font></i>\n\n<b>&lt;DIALECT&gt;</b> New Testament of Pastalie\n
accrroad	[akuro^do]\n▪<i><font face='mono'>v.</font></i>\ngive, send: <i><font color='#404040'>Hymmnos oz faura pomb na omnis den accrroad&nbsp;&nbsp;—<font size='1'>EXEC_HARMONIOUS_FUSION/.</font></font></i>\n\n<b>&lt;DIALECT&gt;</b> Central Standard Note\n
acra	[akura]\n▪<i><font face='mono'>adv.</font></i>\nsurely, certainly (Note: Used for expressing something that's highly probable to happen): <i><font color='#404040'>yorr acra firle wael&nbsp;&nbsp;—<font size='1'>EXEC_HARMONIOUS_FUSION/.</font></font></i>\n\n<b>&lt;DIALECT&gt;</b> Central Standard Note\n
adyya	[adei^a]\n▪<i><font face='mono'>n.</font></i>\ntoday\n\n<b>&lt;DIALECT&gt;</b> Central Standard Note\n
afezeria	[afezeria]\n▪<i><font face='mono'>v.</font></i>\nbless: <i><font color='#404040'>wassee zess frawr bautifal en afezeria&nbsp;&nbsp;—<font size='1'>EXEC_over.METHOD_SUBLIMATION/.~omness chs ciel sos infel</font></font></i>\n\n<b>&lt;DIALECT&gt;</b> Central Standard Note\n
ag	[agu]\n▪<i><font face='mono'>conj.</font></i>\nand (Note: Equivalent to the English "and"): <i><font color='#404040'>x. harr h.m.m.r. eje ag dazua&nbsp;&nbsp;—<font size='1'>METHOD_REPLEKIA/.</font></font></i>\n\n<b>&lt;DIALECT&gt;</b> New Testament of Pastalie\n
aiph	[aifu]\n▪<i><font face='mono'>conj.</font></i>\nif: <i><font color='#404040'>Nnoi crown aiph arsye yor&nbsp;&nbsp;—<font size='1'>The Heart Speaks</font></font></i>\n\n<b>&lt;DIALECT&gt;</b> Central Standard Note\n
aje	[ajie]\n▪<i><font face='mono'>adj.</font></i>\nnew: <i><font color='#404040'>x. harr m.r.r. aje tafane sphaela&nbsp;&nbsp;—<font size='1'>METHOD_REPLEKIA/.</font></font></i>\n\n<b>&lt;DIALECT&gt;</b> New Testament of Pastalie\n
akata	[akata]\n▪<i><font face='mono'>n.</font></i>\nstory: <i><font color='#404040'>Yanyaue akata messe anw hymmne an fhyu&nbsp;&nbsp;—<font size='1'>EXEC_VIENA/.</font></font></i>\n\n<b>&lt;DIALECT&gt;</b> Central Standard Note\n
ale	[a^re]\n▪<i><font face='mono'>n.</font></i>\nsound\n\n<b>&lt;DIALECT&gt;</b> New Testament of Pastalie\n
alroen	[?]\n▪<i><font face='mono'>n.</font></i>\nProof, testimony\n\n<b>&lt;DIALECT&gt;</b> Unknown [Unofficial]\n
alroetsue	[auroettoyu^e]\n▪<i><font face='mono'>adj.</font></i>\nof atonement, of recompense\n\n<b>&lt;DIALECT&gt;</b> Metafalss Note\n
ammue	[amyu]\n▪<i><font face='mono'>n.</font></i>\nsound, sound waves\n\n<b>&lt;DIALECT&gt;</b> Cult Ciel Note\n
amyure	[?]\n▪<i><font face='mono'>noun</font></i>\nrepentance, penitence \n\n<b>&lt;DIALECT&gt;</b> Unknown [Unofficial]\n
an	[an]\n▪<i><font face='mono'>adv.</font></i>\ntogether: <i><font color='#404040'>an Spiritum Sanctum&nbsp;&nbsp;—<font size='1'>EXEC_PURGER/.#Aurica extracting</font></font></i>\n\n<b>&lt;DIALECT&gt;</b> Central Standard Note\n
anw	[anwa , anu]\n▪<i><font face='mono'>prep.</font></i>\n(direct object marker) (Note: The pronunciation changes depending on if the last letter of the preceeding word was a vowel or consonant. The pronunciation used ("anwa" or "anu") depends on which one the speaker thinks that flows and sounds better with the rest of the phrase): <i><font color='#404040'>Rrha ki ra parge_HYMMNOS/1x01 anw SOL=MARTA > A2.&nbsp;&nbsp;—<font size='1'>EXEC_SOL=FAGE/.</font></font></i>\n\n<b>&lt;DIALECT&gt;</b> Metafalss Note\n
apea	[apea]\n▪<i><font face='mono'>E.s. (II)</font></i>\nimmersed in happiness: <i><font color='#404040'>Was apea ra chs yuez en yanje yanje pitod yor&nbsp;&nbsp;—<font size='1'>EXEC_over.METHOD_SUBLIMATION/.~omness chs ciel sos infel</font></font></i>\n\n<b>&lt;DIALECT&gt;</b> Cult Ciel Note\n
ar	[aru]\n▪<i><font face='mono'>adj.</font></i>\nonly, unique: <i><font color='#404040'>Wee ki ra ene rre sor hymme ar ciel en rre hymmnos ee powel&nbsp;&nbsp;—<font size='1'>Singing Hill - Harmonics FRELIA </font></font></i>\n\n<b>&lt;DIALECT&gt;</b> Central Standard Note\n
araus	[?]\n▪<i><font face='mono'>v./n.</font></i>\nexchange: <i><font color='#404040'>Wee ki ra araus tes soare en giue mea iem&nbsp;&nbsp;—<font size='1'>EXEC_CHRONICLE KEY</font></font></i>\n\n<b>&lt;DIALECT&gt;</b> Unknown [Unofficial]\n
arhou	[a^fu^]\n▪<i><font face='mono'>n.</font></i>\nhope, wish, blessing: <i><font color='#404040'>x. rre h.k.t.t nafan ouwua siann arhou&nbsp;&nbsp;—<font size='1'>METHOD_REPLEKIA/.</font></font></i>\n\n<b>&lt;DIALECT&gt;</b> New Testament of Pastalie\n
arrya	[arya]\n▪<i><font face='mono'>n.</font></i>\narrow\n\n<b>&lt;DIALECT&gt;</b> Central Standard Note\n
arsye	[a^shie]\n▪<i><font face='mono'>v.</font></i>\nshare: <i><font color='#404040'>Nnoi crown touwaka arsye yor&nbsp;&nbsp;—<font size='1'>The Heart Speaks</font></font></i>\n\n<b>&lt;DIALECT&gt;</b> Central Standard Note\n
art	[aruto]\n▪<i><font face='mono'>conj.</font></i>\nbecause of, by means of: <i><font color='#404040'>fulual 1 dornpica art 1 walasye enne&nbsp;&nbsp;—<font size='1'>EXEC_HIBERNATION/.</font></font></i>\n\n<b>&lt;DIALECT&gt;</b> Central Standard Note\n
asyar	[?]\n▪<i><font face='mono'>verb</font></i>\nmelt into \n\n<b>&lt;DIALECT&gt;</b> Unknown [Unofficial]\n
aterra	[?]\n▪<i><font face='mono'>v./n.</font></i>\naccept, receive: <i><font color='#404040'>presia aterra cremia sos viuy lonfa&nbsp;&nbsp;—<font size='1'>EXEC_CHRONICLE KEY</font></font></i>\n\n<b>&lt;DIALECT&gt;</b> Unknown [Unofficial]\n
ates	[?]\n▪<i><font face='mono'>v.</font></i>\naccept, receive: <i><font color='#404040'>Was paks ra ates omnis&nbsp;&nbsp;—<font size='1'>EXEC_with.METHOD_METAFALICA/.</font></font></i>\n\n<b>&lt;DIALECT&gt;</b> Unknown [Unofficial]\n
au	[au]\n▪<i><font face='mono'>E.s. (II)</font></i>\nsad: <i><font color='#404040'>Was au ga whai pauwel ferda enter whou na nedle sor&nbsp;&nbsp;—<font size='1'>EXEC_CHRONICLE KEY</font></font></i>\n\n<b>&lt;DIALECT&gt;</b> Alpha Note (EOLIA)\n
aulla	[aura]\n▪<i><font face='mono'>v.</font></i>\nopen, disclose, reveal: <i><font color='#404040'>mea irs here aulla omnis&nbsp;&nbsp;—<font size='1'>EXEC_SPHILIA/.</font></font></i>\n\n<b>&lt;DIALECT&gt;</b> Central Standard Note\n
ayulsa	[ayurusa]\n▪<i><font face='mono'>n.</font></i>\neternity, for the eternity, continues forever: <i><font color='#404040'>x. rre f.r.l. h.l.s.s. ayulsa dazua&nbsp;&nbsp;—<font size='1'>METHOD_REPLEKIA/.</font></font></i>\n\n<b>&lt;DIALECT&gt;</b> New Testament of Pastalie\n
balduo	[barudou^]\n▪<i><font face='mono'>adj.</font></i>\ndark, of darkness, unable to be seen: <i><font color='#404040'>x. sorr k.v.r. du qejyu dn balduo&nbsp;&nbsp;—<font size='1'>METHOD_REPLEKIA/.</font></font></i>\n\n<b>&lt;DIALECT&gt;</b> New Testament of Pastalie\n
bale	[bare]\n▪<i><font face='mono'>n.</font></i>\nball, jewel\n\n<b>&lt;DIALECT&gt;</b> Central Standard Note\n
bansh	[banshu]\n▪<i><font face='mono'>v.</font></i>\n(violently) open (a door etc.)\n\n<b>&lt;DIALECT&gt;</b> Central Standard Note\n
basilic	[bajiriku]\n▪<i><font face='mono'>n.</font></i>\nbig snake, (derivative meanings) gun, cannon\n\n<b>&lt;DIALECT&gt;</b> Central Standard Note\n
bautifal	[bateifaru]\n▪<i><font face='mono'>adj.</font></i>\nbeautiful: <i><font color='#404040'>Was yea ra vit bautifal faura anw dornpica&nbsp;&nbsp;—<font size='1'>EXEC_HIBERNATION/.</font></font></i>\n\n<b>&lt;DIALECT&gt;</b> Central Standard Note\n
beja	[beja]\n▪<i><font face='mono'>v.</font></i>\ndirty, defile: <i><font color='#404040'>Vinan wis pitod re beja&nbsp;&nbsp;—<font size='1'>Colors~SEN~Will This Flower Bloom? 	</font></font></i>\n\n<b>&lt;DIALECT&gt;</b> Cult Ciel Note\n
beng	[bengu]\n▪<i><font face='mono'>conj.</font></i>\nbefore (time), ago\n\n<b>&lt;DIALECT&gt;</b> Central Standard Note\n
bengnuih	[benui]\n▪<i><font face='mono'>n.</font></i>\nevening, dusk\n\n<b>&lt;DIALECT&gt;</b> Central Standard Note\n
bexm	[bezumu]\n▪<i><font face='mono'>v.</font></i>\ncome (time): <i><font color='#404040'>En 1 dyyal nuih bexm&nbsp;&nbsp;—<font size='1'>EXEC_HIBERNATION/.</font></font></i>\n\n<b>&lt;DIALECT&gt;</b> Central Standard Note\n
biron	[biron]\n▪<i><font face='mono'>v.</font></i>\ncontinue: <i><font color='#404040'>Rrha ki ra biron wael wassa&nbsp;&nbsp;—<font size='1'>EXEC_SOL=FAGE/.</font></font></i>\n\n<b>&lt;DIALECT&gt;</b> Central Standard Note\n
bister	[bisuteru]\n▪<i><font face='mono'>n.</font></i>\nbeast: <i><font color='#404040'>chs bister en rana anw dor&nbsp;&nbsp;—<font size='1'>EXEC_over.METHOD_SUBLIMATION/.~omness chs ciel sos infel</font></font></i>\n\n<b>&lt;DIALECT&gt;</b> Central Standard Note\n
boches	[bochiesu]\n▪<i><font face='mono'>n.</font></i>\nmouth\n\n<b>&lt;DIALECT&gt;</b> Central Standard Note\n
boh	[boffu]\n▪<i><font face='mono'>adj.</font></i>\nexplosive, supernatural\n\n<b>&lt;DIALECT&gt;</b> Metafalss Note\n
brinch	[burinku]\n▪<i><font face='mono'>n.</font></i>\nbranch\n\n<b>&lt;DIALECT&gt;</b> Central Standard Note\n
briyante	[buriiyante]\n▪<i><font face='mono'>n.</font></i>\nvoices of delight, voices of joy: <i><font color='#404040'>Rrha ki ra briyante fayra&nbsp;&nbsp;—<font size='1'>EXEC_HIBERNATION/.</font></font></i>\n\n<b>&lt;DIALECT&gt;</b> Metafalss Note\n
briyua	[?]\n▪<i><font face='mono'>adjective</font></i>\nhappy, joyful \n\n<b>&lt;DIALECT&gt;</b> Unknown [Unofficial]\n
burle	[buure]\n▪<i><font face='mono'>adj./n.</font></i>\nblue: <i><font color='#404040'>celetille burle bautifal grrena&nbsp;&nbsp;—<font size='1'>Colors~SEN~Will This Flower Bloom? 	</font></font></i>\n\n<b>&lt;DIALECT&gt;</b> Central Standard Note\n
byui	[?]\n▪<i><font face='mono'>conj.</font></i>\nblame, cause of: <i><font color='#404040'>x. rre h.m.m.r. byui q.l.s. du sechel&nbsp;&nbsp;—<font size='1'>METHOD_REPLEKIA/.</font></font></i>\n\n<b>&lt;DIALECT&gt;</b> Pastalie [Unofficial]\n
c.z.	[suzu]\n▪<i><font face='mono'>E.v.</font></i>\ntransform: <i><font color='#404040'>c.z. yor li yanje&nbsp;&nbsp;—<font size='1'>jy ra cc ci ce je xa jy r acc ci ce je xa rcc jy ra cc ar foul</font></font></i>\n\n<b>&lt;DIALECT&gt;</b> New Testament of Pastalie\n
calamila	[?]\n▪<i><font face='mono'>noun</font></i>\ncatastrophe \n\n<b>&lt;DIALECT&gt;</b> Unknown [Unofficial]\n
cause	[kauze]\n▪<i><font face='mono'>v.</font></i>\ncurse, torment: <i><font color='#404040'>Rrha paks ra chs shazra cause yor&nbsp;&nbsp;—<font size='1'>EXEC_DESPEDIA/.</font></font></i>\n\n<b>&lt;DIALECT&gt;</b> Metafalss Note\n
cecet	[keketo]\n▪<i><font face='mono'>n.</font></i>\nshield\n\n<b>&lt;DIALECT&gt;</b> Central Standard Note\n
ceku	[seku]\n▪<i><font face='mono'>n.</font></i>\nfriend, comrade, companion, comrade\n\n<b>&lt;DIALECT&gt;</b> New Testament of Pastalie\n
celetille	[sereteiru]\n▪<i><font face='mono'>adj.</font></i>\nvivid, clear, fresh, beautiful: <i><font color='#404040'>celetille clalliss xel marta pom mea&nbsp;&nbsp;—<font size='1'>EXEC_HARMONIOUS_FUSION/.</font></font></i>\n\n<b>&lt;DIALECT&gt;</b> Central Standard Note\n
celle	[serure]\n▪<i><font face='mono'>adv.</font></i>\nheavenly: <i><font color='#404040'>ciel ar celle weak ar quive&nbsp;&nbsp;—<font size='1'>Colors~SEN~Will This Flower Bloom? 	</font></font></i>\n\n<b>&lt;DIALECT&gt;</b> Central Standard Note\n
cenjue	[chienjue]\n▪<i><font face='mono'>v.</font></i>\nchange, transform (Note: Has stronger connotations than "chs". This one doesn't mean the "wish" to change, but rather actually changing. It's an orthodox word not used by normal people. If it's preceeded by "na", then it takes the opposite meaning: indicating extreme firmness and determination): <i><font color='#404040'>en whai pauwel gaunji yasra whou na cenjue sor tou zuieg&nbsp;&nbsp;—<font size='1'>EXEC_CHRONICLE KEY</font></font></i>\n\n<b>&lt;DIALECT&gt;</b> Metafalss Note\n
cerchio	[chierukio]\n▪<i><font face='mono'>n.</font></i>\npossibility\n\n<b>&lt;DIALECT&gt;</b> Central Standard Note\n
cest	[sesuto]\n▪<i><font face='mono'>adj./n.</font></i>\nof the true, true, real, truth: <i><font color='#404040'>celetille clalliss cest innna mea&nbsp;&nbsp;—<font size='1'>Colors~SEN~Will This Flower Bloom? 	</font></font></i>\n\n<b>&lt;DIALECT&gt;</b> Central Standard Note\n
cexm	[sezumu]\n▪<i><font face='mono'>v.</font></i>\ncome (person), visit: <i><font color='#404040'>Wee yea ra wael dauan bexm xl yor cexm mea&nbsp;&nbsp;—<font size='1'>EXEC_VIENA/.</font></font></i>\n\n<b>&lt;DIALECT&gt;</b> Central Standard Note\n
chanti	[shantei]\n▪<i><font face='mono'>n./v.</font></i>\npraise, reward: <i><font color='#404040'>weal acra yorr chanti mea&nbsp;&nbsp;—<font size='1'>EXEC_HARMONIOUS_FUSION/.</font></font></i>\n\n<b>&lt;DIALECT&gt;</b> Central Standard Note\n
chess	\n▪<i><font face='mono'>n./v.</font></i>\nkiss: <i><font color='#404040'>chess tes rudje&nbsp;&nbsp;—<font size='1'>EXEC_HARMONIOUS_FUSION/.</font></font></i>\n\n<b>&lt;DIALECT&gt;</b> \n
chiess	[chiesu]\n▪<i><font face='mono'>n./v.</font></i>\nkiss\n\n<b>&lt;DIALECT&gt;</b> Central Standard Note\n
chs	[chisu]\n▪<i><font face='mono'>v.</font></i>\nbecome (Note: Used metaphorically for whenever one wishes to change completely. It has an enormous variety of uses): <i><font color='#404040'>Was yea ra chs mea yor en fwal&nbsp;&nbsp;—<font size='1'>Singing Hill</font></font></i>\n\n<b>&lt;DIALECT&gt;</b> Central Standard Note\n
chsee	[chi^se]\n▪<i><font face='mono'>v.</font></i>\ntransform into ~ (Note: Indicates increase, partial change or reductions on oneself or in the target. In short, it's used to express partial physical change).: <i><font color='#404040'>En chsee fwal fwal mea&nbsp;&nbsp;—<font size='1'>EXEC_LINKER</font></font></i>\n\n<b>&lt;DIALECT&gt;</b> Central Standard Note\n
chyet	[shietsu]\n▪<i><font face='mono'>adj.</font></i>\nchosen, particular\n\n<b>&lt;DIALECT&gt;</b> Cult Ciel Note\n
cia	[shia]\n▪<i><font face='mono'>n.</font></i>\nsky: <i><font color='#404040'>ar w.r.l. du cia dn ryewa keg&nbsp;&nbsp;—<font size='1'>METHOD_METAFALICA/.</font></font></i>\n\n<b>&lt;DIALECT&gt;</b> New Testament of Pastalie\n
ciel	[shie^ru]\n▪<i><font face='mono'>n.</font></i>\nsky, (translated usually as) world: <i><font color='#404040'>Wee ki ra ene rre sor hymme ar ciel en rre hymmnos ee powel&nbsp;&nbsp;—<font size='1'>Singing Hill - Harmonics FRELIA </font></font></i>\n\n<b>&lt;DIALECT&gt;</b> Central Standard Note\n
ciellenne	[shierure^nie]\n▪<i><font face='mono'>n.</font></i>\nthe skies\n\n<b>&lt;DIALECT&gt;</b> Central Standard Note\n
cietta	[?]\n▪<i><font face='mono'>conjunction</font></i>\nbecause, but, although \n\n<b>&lt;DIALECT&gt;</b> Unknown [Unofficial]\n
clalliss	[kurarisu]\n▪<i><font face='mono'>n./v.</font></i>\ncolor: <i><font color='#404040'>clalliss vinan frawr&nbsp;&nbsp;—<font size='1'>EXEC_HARMONIOUS_FUSION/.</font></font></i>\n\n<b>&lt;DIALECT&gt;</b> Central Standard Note\n
clamour	[kurama^]\n▪<i><font face='mono'>n.</font></i>\nknee, lap: <i><font color='#404040'>Hyear Ma num ra gyusya yorr dewee won clamour yor&nbsp;&nbsp;—<font size='1'>EXEC_DESPEDIA/.</font></font></i>\n\n<b>&lt;DIALECT&gt;</b> Central Standard Note\n
clare	[kurare]\n▪<i><font face='mono'>adj.</font></i>\nclear, transparent: <i><font color='#404040'>lusye ar clare&nbsp;&nbsp;—<font size='1'>Colors~SEN~Will This Flower Bloom? 	</font></font></i>\n\n<b>&lt;DIALECT&gt;</b> Central Standard Note\n
clemezen	[kuremuzen]\n▪<i><font face='mono'>adj./n.</font></i>\ninsane, insanity: <i><font color='#404040'>Rrha yea ra dsier yor rol clemezen&nbsp;&nbsp;—<font size='1'>EXEC_DESPEDIA/.</font></font></i>\n\n<b>&lt;DIALECT&gt;</b> Central Standard Note\n
clyncye	[kurinshie]\n▪<i><font face='mono'>n.</font></i>\npurity, colorlessness: <i><font color='#404040'>clyncye rudje clalliss mea&nbsp;&nbsp;—<font size='1'>Colors~SEN~Will This Flower Bloom? 	</font></font></i>\n\n<b>&lt;DIALECT&gt;</b> Cult Ciel Note\n
coall	[?]\n▪<i><font face='mono'>verb</font></i>\nreturn \n\n<b>&lt;DIALECT&gt;</b> Unknown [Unofficial]\n
colga	[kuoruga]\n▪<i><font face='mono'>n.</font></i>\nice\n\n<b>&lt;DIALECT&gt;</b> Central Standard Note\n
colgen	[?]\n▪<i><font face='mono'>v./adj.</font></i>\nfreeze, frozen: <i><font color='#404040'>Ween colgen fayra Race mea wis gigeadeth zeeth tie yor&nbsp;&nbsp;—<font size='1'>EXEC_DESPEDIA/.</font></font></i>\n\n<b>&lt;DIALECT&gt;</b> Unknown [Unofficial]\n
coree	[?]\n▪<i><font face='mono'>preposition</font></i>\nwithin my heart \n\n<b>&lt;DIALECT&gt;</b> Unknown [Unofficial]\n
corle	[?]\n▪<i><font face='mono'>noun</font></i>\nshard, fragment \n\n<b>&lt;DIALECT&gt;</b> Unknown [Unofficial]\n
corpu	[?]\n▪<i><font face='mono'>noun</font></i>\nbody, flesh \n\n<b>&lt;DIALECT&gt;</b> Unknown [Unofficial]\n
crannidale	[kuranida^re]\n▪<i><font face='mono'>v.</font></i>\nshare, (possible alternate translation) believe: <i><font color='#404040'>crannidale infel en kapa&nbsp;&nbsp;—<font size='1'>EXEC_METAFALICA/.</font></font></i>\n\n<b>&lt;DIALECT&gt;</b> Metafalss Note\n
cremia	[?]\n▪<i><font face='mono'>v./n,</font></i>\nsalvation: <i><font color='#404040'>presia aterra cremia sos viuy lonfa&nbsp;&nbsp;—<font size='1'>EXEC_CHRONICLE KEY</font></font></i>\n\n<b>&lt;DIALECT&gt;</b> Unknown [Unofficial]\n
crown	[?]\n▪<i><font face='mono'>n.</font></i>\ncup (for beverages): <i><font color='#404040'>Nnoi crown touwaka arsye yor&nbsp;&nbsp;—<font size='1'>The Heart Speaks</font></font></i>\n\n<b>&lt;DIALECT&gt;</b> Unknown [Unofficial]\n
crudea	[kuru^dea]\n▪<i><font face='mono'>n.</font></i>\nanguish, suffering: <i><font color='#404040'>en sorr quen art ftt omnis crudea&nbsp;&nbsp;—<font size='1'>EXEC_over.METHOD_SUBLIMATION/.~omness chs ciel sos infel</font></font></i>\n\n<b>&lt;DIALECT&gt;</b> Metafalss Note\n
crushue	[kurushu^e]\n▪<i><font face='mono'>v.</font></i>\nspin (fabric), (translated usually as) craft: <i><font color='#404040'>Was yea ra enne en crushue gyen METAFALICA ee sosar&nbsp;&nbsp;—<font size='1'>Singing Hill - Harmonics FRELIA </font></font></i>\n\n<b>&lt;DIALECT&gt;</b> Metafalss Note\n
cupla	[kyupuru]\n▪<i><font face='mono'>n.</font></i>\nsin: <i><font color='#404040'>na siss cupla&nbsp;&nbsp;—<font size='1'>EXEC_SPHILIA/.</font></font></i>\n\n<b>&lt;DIALECT&gt;</b> Central Standard Note\n
cyuie	[kyui]\n▪<i><font face='mono'>adj.</font></i>\nsad, sorrowful: <i><font color='#404040'>Rrha cyuie gaya na ieeya crushue anw dornpica rhaplanca&nbsp;&nbsp;—<font size='1'>EXEC_HIBERNATION/.</font></font></i>\n\n<b>&lt;DIALECT&gt;</b> Central Standard Note\n
cyurio	[kyurio]\n▪<i><font face='mono'>n.</font></i>\nreason, logic, order\n\n<b>&lt;DIALECT&gt;</b> Central Standard Note\n
d.n.	[doun]\n▪<i><font face='mono'>E.v.</font></i>\ndance\n\n<b>&lt;DIALECT&gt;</b> New Testament of Pastalie\n
d.n.g.	[?]\n▪<i><font face='mono'>E.v.</font></i>\npierce\n\n<b>&lt;DIALECT&gt;</b> Pastalie [Unofficial]\n
d.r.s.n.	[?]\n▪<i><font face='mono'>E.v.</font></i>\nhanded down, passed down, passed on: <i><font color='#404040'>x. sorr d.r.s.n. sarla vl shen&nbsp;&nbsp;—<font size='1'>METHOD_METAFALICA/.</font></font></i>\n\n<b>&lt;DIALECT&gt;</b> Pastalie [Unofficial]\n
d.s.s.n.	[?]\n▪<i><font face='mono'>E.v.</font></i>\naccept the atonement\n\n<b>&lt;DIALECT&gt;</b> Pastalie [Unofficial]\n
d.z.	[zu]\n▪<i><font face='mono'>E.v.</font></i>\ndie\n\n<b>&lt;DIALECT&gt;</b> New Testament of Pastalie\n
daedu	[daedousu]\n▪<i><font face='mono'>n.</font></i>\neyesore, something ugly: <i><font color='#404040'>x. sorr m.r.r. du daedu ag ujes&nbsp;&nbsp;—<font size='1'>METHOD_REPLEKIA/.</font></font></i>\n\n<b>&lt;DIALECT&gt;</b> New Testament of Pastalie\n
daf	[?]\n▪<i><font face='mono'>preposition</font></i>\nfor, that \n\n<b>&lt;DIALECT&gt;</b> Unknown [Unofficial]\n
dand	[dando]\n▪<i><font face='mono'>n.</font></i>\ndoor\n\n<b>&lt;DIALECT&gt;</b> Central Standard Note\n
dauan	[dauan]\n▪<i><font face='mono'>n.</font></i>\ndawn: <i><font color='#404040'>Ma num ra slep faura etealune na dauan&nbsp;&nbsp;—<font size='1'>EXEC_HIBERNATION/.</font></font></i>\n\n<b>&lt;DIALECT&gt;</b> Central Standard Note\n
dauane	[dauane]\n▪<i><font face='mono'>adj.</font></i>\nof the dawn: <i><font color='#404040'>wassee forgandal dauane keenis na nozess&nbsp;&nbsp;—<font size='1'>EXEC_over.METHOD_SUBLIMATION/.~omness chs ciel sos infel</font></font></i>\n\n<b>&lt;DIALECT&gt;</b> Central Standard Note\n
dazua	[?]\n▪<i><font face='mono'>n./adj.</font></i>\ndarkness, dark: <i><font color='#404040'>x. harr h.m.m.r. eje ag dazua&nbsp;&nbsp;—<font size='1'>METHOD_REPLEKIA/.</font></font></i>\n\n<b>&lt;DIALECT&gt;</b> Pastalie [Unofficial]\n
dea	[?]\n▪<i><font face='mono'>preposition, particle</font></i>\nwith, by means of \n\n<b>&lt;DIALECT&gt;</b> Unknown [Unofficial]\n
deata	[da^te]\n▪<i><font face='mono'>v.</font></i>\njudge, convict, administer judgment: <i><font color='#404040'>Wassee fatere gyajlee deata&nbsp;&nbsp;—<font size='1'>EXEC_over.METHOD_SUBLIMATION/.~omness chs ciel sos infel</font></font></i>\n\n<b>&lt;DIALECT&gt;</b> Cult Ciel Note\n
deggeez	[deiji^zu]\n▪<i><font face='mono'>v./n.</font></i>\nbetray, disobey, betrayal: <i><font color='#404040'>En yorr re deggeez art ciel&nbsp;&nbsp;—<font size='1'>EXEC_SPHILIA/.</font></font></i>\n\n<b>&lt;DIALECT&gt;</b> Central Standard Note\n
degle	[deguru]\n▪<i><font face='mono'>v.</font></i>\ndestroy, overthrow, ruin\n\n<b>&lt;DIALECT&gt;</b> Cult Ciel Note\n
dejuy	[dejui]\n▪<i><font face='mono'>n.</font></i>\natonement\n\n<b>&lt;DIALECT&gt;</b> New Testament of Pastalie\n
deleir	[dereia]\n▪<i><font face='mono'>n.</font></i>\ncalamity, disaster: <i><font color='#404040'>fatere tes pauwel chs deleir en ousye yor&nbsp;&nbsp;—<font size='1'>EXEC_CHRONICLE KEY</font></font></i>\n\n<b>&lt;DIALECT&gt;</b> Alpha Note (EOLIA)\n
delij	[douerijji]\n▪<i><font face='mono'>v.</font></i>\nhate, shun, neglect: <i><font color='#404040'>aiph yos delij zuieg en nedle eterne falfa&nbsp;&nbsp;—<font size='1'>EXEC_CHRONICLE KEY</font></font></i>\n\n<b>&lt;DIALECT&gt;</b> Alpha Note (EOLIA)\n
den	[den]\n▪<i><font face='mono'>conj.</font></i>\nhowever, but, still, and yet (Note: Connective for opposite sentences): <i><font color='#404040'>Hymmnos oz faura pomb na omnis den accrroad&nbsp;&nbsp;—<font size='1'>EXEC_HARMONIOUS_FUSION/.</font></font></i>\n\n<b>&lt;DIALECT&gt;</b> Central Standard Note\n
denera	[denera]\n▪<i><font face='mono'>n.</font></i>\nevil one: <i><font color='#404040'>Was i ga denera wart&nbsp;&nbsp;—<font size='1'>EXEC_HIBERNATION/.</font></font></i>\n\n<b>&lt;DIALECT&gt;</b> Central Standard Note\n
der	[dea]\n▪<i><font face='mono'>prep.</font></i>\naccording to, by means of: <i><font color='#404040'>Forgandal ar dius near grandus mea der dilete&nbsp;&nbsp;—<font size='1'>Singing Hill - Harmonics FRELIA </font></font></i>\n\n<b>&lt;DIALECT&gt;</b> Metafalss Note\n
desfel	[deisuferu]\n▪<i><font face='mono'>adj./v.</font></i>\nhate, dislike, detestable, unpleasant: <i><font color='#404040'>Yorr desfel&nbsp;&nbsp;—<font size='1'>EXEC_SPHILIA/.</font></font></i>\n\n<b>&lt;DIALECT&gt;</b> Metafalss Note\n
dest	[?]\n▪<i><font face='mono'>verb</font></i>\ndestroy, obliterate, bring to an end \n\n<b>&lt;DIALECT&gt;</b> Unknown [Unofficial]\n
deu	[?]\n▪<i><font face='mono'>preposition, particle</font></i>\nthus, therefore, and \n\n<b>&lt;DIALECT&gt;</b> Unknown [Unofficial]\n
dewee	[?]\n▪<i><font face='mono'>v.</font></i>\nkneel: <i><font color='#404040'>Hyear Ma num ra gyusya yorr dewee won clamour yor&nbsp;&nbsp;—<font size='1'>EXEC_DESPEDIA/.</font></font></i>\n\n<b>&lt;DIALECT&gt;</b> Unknown [Unofficial]\n
dgal	[?]\n▪<i><font face='mono'>n.</font></i>\ncountry, land: <i><font color='#404040'>x. rre vege dgal a.u.k. zz papana&nbsp;&nbsp;—<font size='1'>METHOD_METAFALICA/.</font></font></i>\n\n<b>&lt;DIALECT&gt;</b> Pastalie [Unofficial]\n
dhezeall	[dei^jiaru]\n▪<i><font face='mono'>n./adj.</font></i>\ncaptive, prisoner, imprisoned: <i><font color='#404040'>Ma num ra tictim yorr wis dhezeall DESPEDIA/.&nbsp;&nbsp;—<font size='1'>EXEC_DESPEDIA/.</font></font></i>\n\n<b>&lt;DIALECT&gt;</b> Metafalss Note\n
diasee	[deiazuie^]\n▪<i><font face='mono'>n.</font></i>\nchild of God: <i><font color='#404040'>Was yea ra crushue diasee rhaplanca dornpica&nbsp;&nbsp;—<font size='1'>EXEC_HIBERNATION/.</font></font></i>\n\n<b>&lt;DIALECT&gt;</b> Metafalss Note\n
didalia	[daidaria]\n▪<i><font face='mono'>adj.</font></i>\nlarge: <i><font color='#404040'>tes didalia dorn&nbsp;&nbsp;—<font size='1'>EXEC_METAFALICA/.</font></font></i>\n\n<b>&lt;DIALECT&gt;</b> Cult Ciel Note\n
dilete	[deire^te]\n▪<i><font face='mono'>n.</font></i>\nGod's breath, God's divine protection (Song Magic effects is defense and status increases): <i><font color='#404040'>Was yea ra hymme dilete yor enter ar ciel yehar&nbsp;&nbsp;—<font size='1'>Singing Hill - Harmonics FRELIA </font></font></i>\n\n<b>&lt;DIALECT&gt;</b> Central Standard Note\n
discest	[deisesuto]\n▪<i><font face='mono'>v./n.</font></i>\nlie, cheat, trick: <i><font color='#404040'>llizz discest vine den kuhle&nbsp;&nbsp;—<font size='1'>The Heart Speaks</font></font></i>\n\n<b>&lt;DIALECT&gt;</b> Central Standard Note\n
dius	[deiusu]\n▪<i><font face='mono'>adj.</font></i>\ndivine, sacred, precious, valuable, sublime, solemn, noble: <i><font color='#404040'>Forgandal ar dius near grandus mea der dilete&nbsp;&nbsp;—<font size='1'>Singing Hill - Harmonics FRELIA </font></font></i>\n\n<b>&lt;DIALECT&gt;</b> Cult Ciel Note\n
diviega	[deivie^ga]\n▪<i><font face='mono'>n., adj.</font></i>\nsacred sword, (derivative meaning) great wisdom: <i><font color='#404040'>ya ya diviega ya ya ya ya ya enclone sor en rre hymmnos ee powel&nbsp;&nbsp;—<font size='1'>Singing Hill - Harmonics FRELIA </font></font></i>\n\n<b>&lt;DIALECT&gt;</b> Cult Ciel Note\n
dje	[?]\n▪<i><font face='mono'>n.</font></i>\nbody: <i><font color='#404040'>x. rre govan en wefa sarla f.w.r.n. du dje&nbsp;&nbsp;—<font size='1'>METHOD_METAFALICA/.</font></font></i>\n\n<b>&lt;DIALECT&gt;</b> Pastalie [Unofficial]\n
dn	[doun]\n▪<i><font face='mono'>p.</font></i>\n(instrument/location/cause/time marker) (Note: Used to indicate means. Equivalent to the English "by").: <i><font color='#404040'>x. sorr k.v.r. du qejyu dn balduo&nbsp;&nbsp;—<font size='1'>METHOD_REPLEKIA/.</font></font></i>\n\n<b>&lt;DIALECT&gt;</b> New Testament of Pastalie\n
doodu	[do^dou]\n▪<i><font face='mono'>n.</font></i>\nground, earth: <i><font color='#404040'>x. rre omness a.u.k. zodaw ess rudje noglle doodu&nbsp;&nbsp;—<font size='1'>EXEC_over.METHOD_SUBLIMATION/.~lamenza</font></font></i>\n\n<b>&lt;DIALECT&gt;</b> New Testament of Pastalie\n
dople	[dopure]\n▪<i><font face='mono'>v.</font></i>\nremove, exclude, reject: <i><font color='#404040'>tasyue anw ciel en dople anw omnis lamenza&nbsp;&nbsp;—<font size='1'>EXEC_over.METHOD_SUBLIMATION/.~omness chs ciel sos infel</font></font></i>\n\n<b>&lt;DIALECT&gt;</b> Central Standard Note\n
dor	[do^ru]\n▪<i><font face='mono'>n.</font></i>\nground, continent: <i><font color='#404040'>chs bister en rana anw dor&nbsp;&nbsp;—<font size='1'>EXEC_over.METHOD_SUBLIMATION/.~omness chs ciel sos infel</font></font></i>\n\n<b>&lt;DIALECT&gt;</b> Central Standard Note\n
dorn	[dorun]\n▪<i><font face='mono'>n.</font></i>\ntree, wood: <i><font color='#404040'>sara dorn fhyu hymma&nbsp;&nbsp;—<font size='1'>Singing Hill</font></font></i>\n\n<b>&lt;DIALECT&gt;</b> Central Standard Note\n
dornpica	[dourunpika]\n▪<i><font face='mono'>n.</font></i>\nnut, fruit, seed: <i><font color='#404040'>Was yea ra crushue anw yehah dornpica rhaplanca&nbsp;&nbsp;—<font size='1'>EXEC_HIBERNATION/.</font></font></i>\n\n<b>&lt;DIALECT&gt;</b> Cult Ciel Note\n
dralee	[?]\n▪<i><font face='mono'>v./n.</font></i>\nOffer, offering\n\n<b>&lt;DIALECT&gt;</b> Unknown [Unofficial]\n
drone	[douro^ne]\n▪<i><font face='mono'>v.</font></i>\ndownload, take in: <i><font color='#404040'>exec drone hymmnos enter yor&nbsp;&nbsp;—<font size='1'>Singing Hill</font></font></i>\n\n<b>&lt;DIALECT&gt;</b> Central Standard Note\n
dsier	[diea]\n▪<i><font face='mono'>n.</font></i>\ndesire: <i><font color='#404040'>Was yea ra irs dsier&nbsp;&nbsp;—<font size='1'>EXEC_HIBERNATION/.</font></font></i>\n\n<b>&lt;DIALECT&gt;</b> Central Standard Note\n
du	[dou]\n▪<i><font face='mono'>p.</font></i>\n(direct object marker): <i><font color='#404040'>x. harr k.v.r. du qejyu&nbsp;&nbsp;—<font size='1'>METHOD_REPLEKIA/.</font></font></i>\n\n<b>&lt;DIALECT&gt;</b> New Testament of Pastalie\n
dyya	[dei^a]\n▪<i><font face='mono'>n.</font></i>\nday (Note: Used only for phrases such as "one day" or "that day". For phrases with aa definite number of days, "dyyal" is used instead)\n\n<b>&lt;DIALECT&gt;</b> Central Standard Note\n
dyyal	[dei^aru]\n▪<i><font face='mono'>n.</font></i>\ndays (counter suffix): <i><font color='#404040'>En 1 dyyal nuih bexm&nbsp;&nbsp;—<font size='1'>EXEC_HIBERNATION/.</font></font></i>\n\n<b>&lt;DIALECT&gt;</b> Central Standard Note\n
eazas	[i^zasu]\n▪<i><font face='mono'>adj.</font></i>\nmutually (Note: It can be attached to the end of a verb, like this: "hartes eazas" -> "mutual love"): <i><font color='#404040'>Was quel erra chs lusye eazas&nbsp;&nbsp;—<font size='1'>EXEC_VIENA/.</font></font></i>\n\n<b>&lt;DIALECT&gt;</b> Central Standard Note\n
echrra	[ekura]\n▪<i><font face='mono'>v.</font></i>\nresonate: <i><font color='#404040'>Rrha yea ra rinc en echrra yor rre walasye jyel got ieeya&nbsp;&nbsp;—<font size='1'>Singing Hill - Harmonics FRELIA </font></font></i>\n\n<b>&lt;DIALECT&gt;</b> Central Standard Note\n
ee	[iee]\n▪<i><font face='mono'>v.</font></i>\nexalt, praise: <i><font color='#404040'>Wee ki ra ene rre sor hymme ar ciel en rre hymmnos ee powel&nbsp;&nbsp;—<font size='1'>Singing Hill - Harmonics FRELIA </font></font></i>\n\n<b>&lt;DIALECT&gt;</b> Metafalss Note\n
eetor	[etou^]\n▪<i><font face='mono'>n.</font></i>\nother (side/person)\n\n<b>&lt;DIALECT&gt;</b> Central Standard Note\n
eje	[ejie]\n▪<i><font face='mono'>n.</font></i>\nheart, mind, feeling: <i><font color='#404040'>x. harr h.m.m.r. eje&nbsp;&nbsp;—<font size='1'>METHOD_REPLEKIA/.</font></font></i>\n\n<b>&lt;DIALECT&gt;</b> New Testament of Pastalie\n
elle	[eru]\n▪<i><font face='mono'>prep.</font></i>\nfrom, out of (Note: It's similar in meaning and use to the English "from"): <i><font color='#404040'>tasyue yorr yehar elle fandel hierle&nbsp;&nbsp;—<font size='1'>EXEC_HARMONIOUS_FUSION/.</font></font></i>\n\n<b>&lt;DIALECT&gt;</b> Central Standard Note\n
elye	[erie]\n▪<i><font face='mono'>adv.</font></i>\nhitherto, yet\n\n<b>&lt;DIALECT&gt;</b> New Testament of Pastalie\n
en	[en]\n▪<i><font face='mono'>conj.</font></i>\nand, because, for (Note: Direct equivalent to the English "and"): <i><font color='#404040'>Wee ki ra ene rre sor hymme ar ciel en rre hymmnos ee powel&nbsp;&nbsp;—<font size='1'>Singing Hill - Harmonics FRELIA </font></font></i>\n\n<b>&lt;DIALECT&gt;</b> Central Standard Note\n
enclone	[enkuroune]\n▪<i><font face='mono'>v.</font></i>\nwrap up: <i><font color='#404040'>ya ya diviega ya ya ya ya ya enclone sor en rre hymmnos ee powel&nbsp;&nbsp;—<font size='1'>Singing Hill - Harmonics FRELIA </font></font></i>\n\n<b>&lt;DIALECT&gt;</b> Metafalss Note\n
endia	[endeia]\n▪<i><font face='mono'>v.</font></i>\nstop, end: <i><font color='#404040'>Sos yor yanje revm na endia revm yehah revm&nbsp;&nbsp;—<font size='1'>EXEC_HARMONIOUS_FUSION/.</font></font></i>\n\n<b>&lt;DIALECT&gt;</b> Metafalss Note\n
ene	[enu]\n▪<i><font face='mono'>v.</font></i>\nthink, feel deeply: <i><font color='#404040'>Wee ki ra ene rre sor hymme ar ciel en rre hymmnos ee powel&nbsp;&nbsp;—<font size='1'>Singing Hill - Harmonics FRELIA </font></font></i>\n\n<b>&lt;DIALECT&gt;</b> Cult Ciel Note\n
enegd	[enegudou]\n▪<i><font face='mono'>v.</font></i>\nbecome numb\n\n<b>&lt;DIALECT&gt;</b> Central Standard Note\n
enerel	[enereru]\n▪<i><font face='mono'>adv.</font></i>\nalways, forever\n\n<b>&lt;DIALECT&gt;</b> Cult Ciel Note\n
enesse	[enesse]\n▪<i><font face='mono'>n.</font></i>\nemotion: <i><font color='#404040'>walasye near enesse mea paul li ciel&nbsp;&nbsp;—<font size='1'>Colors~SEN~Will This Flower Bloom? 	</font></font></i>\n\n<b>&lt;DIALECT&gt;</b> Cult Ciel Note\n
engassya	[enga^sha]\n▪<i><font face='mono'>n.</font></i>\nsacrifice\n\n<b>&lt;DIALECT&gt;</b> Central Standard Note\n
engua	[?]\n▪<i><font face='mono'>adjective</font></i>\npredestined, inevitable, unchangeable \n\n<b>&lt;DIALECT&gt;</b> Unknown [Unofficial]\n
enne	[enie]\n▪<i><font face='mono'>n.</font></i>\nprayer, request (with good intentions): <i><font color='#404040'>Was yea ra enne en crushue gyen METAFALICA ee sosar&nbsp;&nbsp;—<font size='1'>Singing Hill - Harmonics FRELIA </font></font></i>\n\n<b>&lt;DIALECT&gt;</b> Central Standard Note\n
enrer	[enrya]\n▪<i><font face='mono'>adv.</font></i>\nalways, usually: <i><font color='#404040'>Wee yea ra ene foul enrer&nbsp;&nbsp;—<font size='1'>Singing Hill</font></font></i>\n\n<b>&lt;DIALECT&gt;</b> Cult Ciel Note\n
enter	[enteru]\n▪<i><font face='mono'>verb</font></i>\nenter : <i><font color='#404040'>Was yea ra hymme dilete yor enter ar ciel yehar&nbsp;&nbsp;—<font size='1'>Singing Hill - Harmonics FRELIA </font></font></i>\n\n<b>&lt;DIALECT&gt;</b> Central Standard Note\n
envied	[?]\n▪<i><font face='mono'>adjective</font></i>\nstupid, idiotic \n\n<b>&lt;DIALECT&gt;</b> Unknown [Unofficial]\n
enw	[en'u]\n▪<i><font face='mono'>conj.</font></i>\nwhile doing ~: <i><font color='#404040'>was yea ra wael yorr uteu enw fernia&nbsp;&nbsp;—<font size='1'>EXEC_over.METHOD_SUBLIMATION/.~omness chs ciel sos infel</font></font></i>\n\n<b>&lt;DIALECT&gt;</b> Central Standard Note\n
erlla	[?]\n▪<i><font face='mono'>adjective, adverb</font></i>\nvery much, more, further \n\n<b>&lt;DIALECT&gt;</b> Unknown [Unofficial]\n
erphy	[?]\n▪<i><font face='mono'>noun</font></i>\nmemory, rememberance \n\n<b>&lt;DIALECT&gt;</b> Unknown [Unofficial]\n
erra	[e^ra]\n▪<i><font face='mono'>E.s. III</font></i>\nI want this to last eternally: <i><font color='#404040'>Was yea erra chs sheak en sol anw yeal&nbsp;&nbsp;—<font size='1'>EXEC_VIENA/.</font></font></i>\n\n<b>&lt;DIALECT&gt;</b> Central Standard Note\n
ess	[e^su]\n▪<i><font face='mono'>prep.</font></i>\n(instrument/location/cause/time marker) (Note: Equivalent to the English "in"): <i><font color='#404040'>x. rre omness a.u.k. zodaw ess rudje noglle doodu&nbsp;&nbsp;—<font size='1'>EXEC_over.METHOD_SUBLIMATION/.~lamenza</font></font></i>\n\n<b>&lt;DIALECT&gt;</b> New Testament of Pastalie\n
et	[e]\n▪<i><font face='mono'>adj.</font></i>\nlarge: <i><font color='#404040'>Wee yea ra hymme hymmnos harmon en syast et wi powel&nbsp;&nbsp;—<font size='1'>Singing Hill - Harmonics FRELIA </font></font></i>\n\n<b>&lt;DIALECT&gt;</b> Central Standard Note\n
eta	[e^ta]\n▪<i><font face='mono'>v.</font></i>\neat: <i><font color='#404040'>Was paks ra eta bautifal faura tes dornpica&nbsp;&nbsp;—<font size='1'>EXEC_HIBERNATION/.</font></font></i>\n\n<b>&lt;DIALECT&gt;</b> Central Standard Note\n
etealune	[eterunee]\n▪<i><font face='mono'>n.</font></i>\neternity: <i><font color='#404040'>Ma num ra slep faura etealune na dauan&nbsp;&nbsp;—<font size='1'>EXEC_HIBERNATION/.</font></font></i>\n\n<b>&lt;DIALECT&gt;</b> Metafalss Note\n
eterne	[ete^rune]\n▪<i><font face='mono'>n.</font></i>\neternity: <i><font color='#404040'>aiph yos delij zuieg en nedle eterne falfa&nbsp;&nbsp;—<font size='1'>EXEC_CHRONICLE KEY</font></font></i>\n\n<b>&lt;DIALECT&gt;</b> Alpha Note (EOLIA)\n
eux	[yukusu]\n▪<i><font face='mono'>n.</font></i>\neye\n\n<b>&lt;DIALECT&gt;</b> Central Standard Note\n
ewle	[?]\n▪<i><font face='mono'>adj.</font></i>\nlong\n\n<b>&lt;DIALECT&gt;</b> Unknown [Unofficial]\n
exali	[?]\n▪<i><font face='mono'>adj.</font></i>\nradiant, dazzling: <i><font color='#404040'>x. rre exali sarr w.r.m. anw sphaela&nbsp;&nbsp;—<font size='1'>METHOD_IMPLANTA/.</font></font></i>\n\n<b>&lt;DIALECT&gt;</b> Pastalie [Unofficial]\n
exec	[eguzeku]\n▪<i><font face='mono'>v.</font></i>\nexecute, put into practise: <i><font color='#404040'>exec drone hymmnos enter yor&nbsp;&nbsp;—<font size='1'>Singing Hill</font></font></i>\n\n<b>&lt;DIALECT&gt;</b> Central Standard Note\n
f.p.n.	[?]\n▪<i><font face='mono'>E.v.</font></i>\ndownpour: <i><font color='#404040'>x. rre vonn papana f.p.n. ut kvyeire qoga iem&nbsp;&nbsp;—<font size='1'>EXEC_over.METHOD_SUBLIMATION/.~lamenza</font></font></i>\n\n<b>&lt;DIALECT&gt;</b> Pastalie [Unofficial]\n
f.r.l.	[fururu]\n▪<i><font face='mono'>E.v.</font></i>\nbe frightened: <i><font color='#404040'>x. rre f.r.l. h.l.s.s. ayulsa dazua&nbsp;&nbsp;—<font size='1'>METHOD_REPLEKIA/.</font></font></i>\n\n<b>&lt;DIALECT&gt;</b> New Testament of Pastalie\n
f.s.	[efusu]\n▪<i><font face='mono'>E.v</font></i>\nwhisper, murmur: <i><font color='#404040'>y.z.t. za rre vega f.s. t.k.d. ag zz t.k.d. tie hartes yor&nbsp;&nbsp;—<font size='1'>METHOD_METAFALICA/.</font></font></i>\n\n<b>&lt;DIALECT&gt;</b> New Testament of Pastalie\n
f.w.r.	[fuuru]\n▪<i><font face='mono'>E.v.</font></i>\naccept\n\n<b>&lt;DIALECT&gt;</b> New Testament of Pastalie\n
f.w.r.n.	[fuurun]\n▪<i><font face='mono'>E.v.</font></i>\nsurround, enfold: <i><font color='#404040'>x. rre govan en wefa sarla f.w.r.n. du dje&nbsp;&nbsp;—<font size='1'>METHOD_METAFALICA/.</font></font></i>\n\n<b>&lt;DIALECT&gt;</b> New Testament of Pastalie\n
faf	[fafu]\n▪<i><font face='mono'>adj.</font></i>\nscary, frightening: <i><font color='#404040'>jenhah gyas faf morto&nbsp;&nbsp;—<font size='1'>Colors~SEN~Will This Flower Bloom? 	</font></font></i>\n\n<b>&lt;DIALECT&gt;</b> Cult Ciel Note\n
faiy	[?]\n▪<i><font face='mono'>adj.</font></i>\nmomentary, transient\n\n<b>&lt;DIALECT&gt;</b> Unknown [Unofficial]\n
faja	[fa^ja]\n▪<i><font face='mono'>v.</font></i>\nadvance, make progress (Note: It's used for indicating the advancing of an individual or small groups. For the advancing of large groups, "Zahha" it's used instead).\n\n<b>&lt;DIALECT&gt;</b> Cult Ciel Note\n
falfa	[?]\n▪<i><font face='mono'>n.</font></i>\npeace: <i><font color='#404040'>aiph yos delij zuieg en nedle eterne falfa&nbsp;&nbsp;—<font size='1'>EXEC_CHRONICLE KEY</font></font></i>\n\n<b>&lt;DIALECT&gt;</b> Unknown [Unofficial]\n
famfa	[fanfa]\n▪<i><font face='mono'>v.</font></i>\nfly, flap wings: <i><font color='#404040'>Chs hymma en famfa der ciel&nbsp;&nbsp;—<font size='1'>EXEC_over.METHOD_SUBLIMATION/.~omness chs ciel sos infel</font></font></i>\n\n<b>&lt;DIALECT&gt;</b> Central Standard Note\n
fanalea	[?]\n▪<i><font face='mono'>adj.</font></i>\nloudly, sonorously\n\n<b>&lt;DIALECT&gt;</b> Unknown [Unofficial]\n
fandel	[fanderu]\n▪<i><font face='mono'>adj.</font></i>\nmany, in great numbers: <i><font color='#404040'>tasyue yorr yehar elle fandel hierle&nbsp;&nbsp;—<font size='1'>EXEC_HARMONIOUS_FUSION/.</font></font></i>\n\n<b>&lt;DIALECT&gt;</b> Metafalss Note\n
fane	[fa^ne]\n▪<i><font face='mono'>n.</font></i>\naffection, kindness, love: <i><font color='#404040'>wassee anw fane lusye&nbsp;&nbsp;—<font size='1'>EXEC_over.METHOD_SUBLIMATION/.~omness chs ciel sos infel</font></font></i>\n\n<b>&lt;DIALECT&gt;</b> Central Standard Note\n
fatele	[fatere^]\n▪<i><font face='mono'>n.</font></i>\nfather: <i><font color='#404040'>Faura sonwe murfan anw fatele&nbsp;&nbsp;—<font size='1'>EXEC_HARMONIOUS</font></font></i>\n\n<b>&lt;DIALECT&gt;</b> Metafalss Note\n
fatere	[fa^tere]\n▪<i><font face='mono'>adv.</font></i>\nif not ~ then probably ~: <i><font color='#404040'>Wassee fatere gyajlee deata&nbsp;&nbsp;—<font size='1'>EXEC_over.METHOD_SUBLIMATION/.~omness chs ciel sos infel</font></font></i>\n\n<b>&lt;DIALECT&gt;</b> Central Standard Note\n
fau	[fau]\n▪<i><font face='mono'>n.</font></i>\nbird (Note: not used for small birds): <i><font color='#404040'>der sacra rol fau ween leaff&nbsp;&nbsp;—<font size='1'>EXEC_HARMONIOUS_FUSION/.</font></font></i>\n\n<b>&lt;DIALECT&gt;</b> Metafalss Note\n
faura	[faura]\n▪<i><font face='mono'>n.</font></i>\nsmall/baby bird: <i><font color='#404040'>Hymmnos oz faura pomb na omnis den accrroad&nbsp;&nbsp;—<font size='1'>EXEC_HARMONIOUS_FUSION/.</font></font></i>\n\n<b>&lt;DIALECT&gt;</b> Metafalss Note\n
fayra	[faira]\n▪<i><font face='mono'>n.</font></i>\nfire, blaze: <i><font color='#404040'>Rrha ki ra briyante fayra&nbsp;&nbsp;—<font size='1'>EXEC_HIBERNATION/.</font></font></i>\n\n<b>&lt;DIALECT&gt;</b> Central Standard Note\n
fedyya	[fidei^a]\n▪<i><font face='mono'>n.</font></i>\ntomorrow (Note: Can also mean "future"): <i><font color='#404040'>Nnoi fedyya murfan arsye yor&nbsp;&nbsp;—<font size='1'>The Heart Speaks</font></font></i>\n\n<b>&lt;DIALECT&gt;</b> Central Standard Note\n
fee	[?]\n▪<i><font face='mono'>n.</font></i>\nwind: <i><font color='#404040'>Wee yea ra enne ar fee ar dor ar ciel&nbsp;&nbsp;—<font size='1'>EXEC_LINKER</font></font></i>\n\n<b>&lt;DIALECT&gt;</b> Unknown [Unofficial]\n
ferda	[feruda]\n▪<i><font face='mono'>v.</font></i>\ndwell, live in: <i><font color='#404040'>Was au ga whai pauwel ferda enter whou na nedle sor&nbsp;&nbsp;—<font size='1'>EXEC_CHRONICLE KEY</font></font></i>\n\n<b>&lt;DIALECT&gt;</b> Metafalss Note\n
fernia	[fe^nya]\n▪<i><font face='mono'>v.</font></i>\nsmile: <i><font color='#404040'>was yea ra wael yorr uteu enw fernia&nbsp;&nbsp;—<font size='1'>EXEC_over.METHOD_SUBLIMATION/.~omness chs ciel sos infel</font></font></i>\n\n<b>&lt;DIALECT&gt;</b> Cult Ciel Note\n
fhau	[?]\n▪<i><font face='mono'>noun</font></i>\nlight \n\n<b>&lt;DIALECT&gt;</b> Unknown [Unofficial]\n
fhauri	[?]\n▪<i><font face='mono'>adjective</font></i>\nlight-borne \n\n<b>&lt;DIALECT&gt;</b> Unknown [Unofficial]\n
fhyu	[hyufu]\n▪<i><font face='mono'>n.</font></i>\nwind: <i><font color='#404040'>sara dorn fhyu hymma&nbsp;&nbsp;—<font size='1'>Singing Hill</font></font></i>\n\n<b>&lt;DIALECT&gt;</b> Central Standard Note\n
firanzia	[?]\n▪<i><font face='mono'>n.</font></i>\nend of the world\n\n<b>&lt;DIALECT&gt;</b> Unknown [Unofficial]\n
firga	[?]\n▪<i><font face='mono'>noun</font></i>\npast \n\n<b>&lt;DIALECT&gt;</b> Unknown [Unofficial]\n
firle	[firure]\n▪<i><font face='mono'>v.</font></i>\nfeel, sense: <i><font color='#404040'>yorr acra firle wael&nbsp;&nbsp;—<font size='1'>EXEC_HARMONIOUS_FUSION/.</font></font></i>\n\n<b>&lt;DIALECT&gt;</b> Metafalss Note\n
flare	[furare]\n▪<i><font face='mono'>v.</font></i>\nfloat, suspend (in the air)\n\n<b>&lt;DIALECT&gt;</b> Central Standard Note\n
flip	[furipu]\n▪<i><font face='mono'>v.</font></i>\nreverse, command for flip-flop conversion: <i><font color='#404040'>Ma num ra flip 0x1011001001 yor&nbsp;&nbsp;—<font size='1'>Singing Hill</font></font></i>\n\n<b>&lt;DIALECT&gt;</b> Cult Ciel Note\n
fluy	[furyui]\n▪<i><font face='mono'>n.</font></i>\nspring, well: <i><font color='#404040'>art mea noes li fluy&nbsp;&nbsp;—<font size='1'>Colors~SEN~Will This Flower Bloom? 	</font></font></i>\n\n<b>&lt;DIALECT&gt;</b> Central Standard Note\n
focs	[?]\n▪<i><font face='mono'>adj.</font></i>\ndeep, thick\n\n<b>&lt;DIALECT&gt;</b> Unknown [Unofficial]\n
fogabe	[fo^geibu]\n▪<i><font face='mono'>v.</font></i>\nforgive, allow, pardon: <i><font color='#404040'>Was i ra presia fogabe marta presia fogabe marta&nbsp;&nbsp;—<font size='1'>Eternally Bonded</font></font></i>\n\n<b>&lt;DIALECT&gt;</b> Central Standard Note\n
folten	[foruten]\n▪<i><font face='mono'>prep.</font></i>\nbefore (position/direction), in front of\n\n<b>&lt;DIALECT&gt;</b> Central Standard Note\n
forgandal	[fo^gandaru]\n▪<i><font face='mono'>Con.</font></i>\nBecause of...!: <i><font color='#404040'>wassee forgandal dauane keenis na nozess&nbsp;&nbsp;—<font size='1'>EXEC_over.METHOD_SUBLIMATION/.~omness chs ciel sos infel</font></font></i>\n\n<b>&lt;DIALECT&gt;</b> Cult Ciel Note\n
forlindel	[fo^rinderu]\n▪<i><font face='mono'>n.</font></i>\nhead family of a village\n\n<b>&lt;DIALECT&gt;</b> Cult Ciel Note\n
forlinden	[fo^rinden]\n▪<i><font face='mono'>n.</font></i>\nvillage\n\n<b>&lt;DIALECT&gt;</b> Cult Ciel Note\n
foul	[fouru]\n▪<i><font face='mono'>n.</font></i>\nwonder, miracle, mystery: <i><font color='#404040'>Wee yea ra ene foul enrer&nbsp;&nbsp;—<font size='1'>Singing Hill</font></font></i>\n\n<b>&lt;DIALECT&gt;</b> Cult Ciel Note\n
fountaina	[faunteina]\n▪<i><font face='mono'>v./adj.</font></i>\nfill up, cover, hide (Note: It can also be used as an adjective to indicate the amount and scope of something): <i><font color='#404040'>fountaina yor der rudje&nbsp;&nbsp;—<font size='1'>EXEC_HARMONIOUS_FUSION/.</font></font></i>\n\n<b>&lt;DIALECT&gt;</b> Central Standard Note\n
fowrlle	[fowa^ru]\n▪<i><font face='mono'>v./n.</font></i>\ncomfort, heal, relaxation: <i><font color='#404040'>Was ki ga fowrlle yor&nbsp;&nbsp;—<font size='1'>EXEC_HARMONIOUS_FUSION/.</font></font></i>\n\n<b>&lt;DIALECT&gt;</b> Central Standard Note\n
frawr	[ra^wa]\n▪<i><font face='mono'>n.</font></i>\nflower: <i><font color='#404040'>chs frawr&nbsp;&nbsp;—<font size='1'>Singing Hill</font></font></i>\n\n<b>&lt;DIALECT&gt;</b> Central Standard Note\n
frawrle	[rawa^ru]\n▪<i><font face='mono'>n.</font></i>\nspring (season)\n\n<b>&lt;DIALECT&gt;</b> Cult Ciel Note\n
frissoner	[furissonea]\n▪<i><font face='mono'>v.</font></i>\nshiver: <i><font color='#404040'>Rrha ki ra frissoner mea spiritum&nbsp;&nbsp;—<font size='1'>EXEC_SOL=FAGE/.</font></font></i>\n\n<b>&lt;DIALECT&gt;</b> Central Standard Note\n
frreie	[?]\n▪<i><font face='mono'>v.</font></i>\nrelease: <i><font color='#404040'>Was yea ra frreie yor wart en chs manaf an yor&nbsp;&nbsp;—<font size='1'>EXEC_LINKER</font></font></i>\n\n<b>&lt;DIALECT&gt;</b> Unknown [Unofficial]\n
fs	[fusu]\n▪<i><font face='mono'>n.</font></i>\nbreeze (when it has an "E" emotion vowel in front, its meaning changes to "whisper").\n\n<b>&lt;DIALECT&gt;</b> New Testament of Pastalie\n
ftt	[futsu]\n▪<i><font face='mono'>v.</font></i>\nvanish: <i><font color='#404040'>Gat fusya en ciel ftt&nbsp;&nbsp;—<font size='1'>EXEC_VIENA/.</font></font></i>\n\n<b>&lt;DIALECT&gt;</b> Central Standard Note\n
fulual	[furuaru]\n▪<i><font face='mono'>v.</font></i>\ncome true (wish): <i><font color='#404040'>fulual 1 dornpica art 1 walasye enne&nbsp;&nbsp;—<font size='1'>EXEC_HIBERNATION/.</font></font></i>\n\n<b>&lt;DIALECT&gt;</b> Central Standard Note\n
fusya	[fu^sha]\n▪<i><font face='mono'>v.</font></i>\nwrap: <i><font color='#404040'>irs jam inferiare yor yehar jyel fusya&nbsp;&nbsp;—<font size='1'>Singing Hill - Harmonics FRELIA </font></font></i>\n\n<b>&lt;DIALECT&gt;</b> Central Standard Note\n
futare	[futa^re]\n▪<i><font face='mono'>n.</font></i>\nfuture: <i><font color='#404040'>van futare parge iem&nbsp;&nbsp;—<font size='1'>EXEC_VIENA/.</font></font></i>\n\n<b>&lt;DIALECT&gt;</b> Central Standard Note\n
fwal	[fuwaru]\n▪<i><font face='mono'>n./v.</font></i>\nwing, advance, transport: <i><font color='#404040'>Was yea ra chs mea yor en fwal&nbsp;&nbsp;—<font size='1'>Singing Hill</font></font></i>\n\n<b>&lt;DIALECT&gt;</b> Cult Ciel Note\n
fwilla	\n▪<i><font face='mono'>n.</font></i>\ndrop, droplet: <i><font color='#404040'>fwilla selena yasra sarla&nbsp;&nbsp;—<font size='1'>Colors~SEN~Will This Flower Bloom? 	</font></font></i>\n\n<b>&lt;DIALECT&gt;</b> \n
fwillra	[fira]\n▪<i><font face='mono'>n.</font></i>\nfeather, plumage, petal (Note: contrary to "fwal", which means "wings", "fwirlla" only refers to the feathers and plumage): <i><font color='#404040'>sash fwillra ween papana&nbsp;&nbsp;—<font size='1'>EXEC_SPHILIA/.</font></font></i>\n\n<b>&lt;DIALECT&gt;</b> Cult Ciel Note\n
g.k.n.	[gatsun]\n▪<i><font face='mono'>E.v.</font></i>\neat\n\n<b>&lt;DIALECT&gt;</b> New Testament of Pastalie\n
g.v.w.	[?]\n▪<i><font face='mono'>E.v.</font></i>\nfight, battle: <i><font color='#404040'>s.l.y. yor sev x. rre yorr g.v.w. en x.y.n.&nbsp;&nbsp;—<font size='1'>METHOD_METAFALICA/.</font></font></i>\n\n<b>&lt;DIALECT&gt;</b> Pastalie [Unofficial]\n
g.w.f.r.	[guufuru]\n▪<i><font face='mono'>E.v.</font></i>\njudge\n\n<b>&lt;DIALECT&gt;</b> New Testament of Pastalie\n
g.w.n.	[?]\n▪<i><font face='mono'>Emotion Verb</font></i>\nlead, guide \n\n<b>&lt;DIALECT&gt;</b> Pastalie [Unofficial]\n
ga	[ga]\n▪<i><font face='mono'>E.s. III</font></i>\nI want this to end soon: <i><font color='#404040'>Ma ki ga ks maya yor syec&nbsp;&nbsp;—<font size='1'>Singing Hill</font></font></i>\n\n<b>&lt;DIALECT&gt;</b> Central Standard Note\n
gagis	[gyagisu]\n▪<i><font face='mono'>E.s. III</font></i>\nI'm all right like this: <i><font color='#404040'>Rrha i gagis guatrz gyas&nbsp;&nbsp;—<font size='1'>EXEC_HIBERNATION/.</font></font></i>\n\n<b>&lt;DIALECT&gt;</b> Metafalss Note\n
ganna	[gana]\n▪<i><font face='mono'>adj./n.</font></i>\nstrong, stubborn, solid, stone, rock (Note: It's normally used to indicate the hardness of a material or the stubbornness of a mind. As a noun, it means "rock" and "stone"): <i><font color='#404040'>cest yor vianchiel ween ganna shell&nbsp;&nbsp;—<font size='1'>EXEC_SPHILIA/.</font></font></i>\n\n<b>&lt;DIALECT&gt;</b> Central Standard Note\n
garlden	[garuden]\n▪<i><font face='mono'>n.</font></i>\ntown\n\n<b>&lt;DIALECT&gt;</b> Central Standard Note\n
gasar	[gasaru]\n▪<i><font face='mono'>n.</font></i>\ndoll, stuffed animal\n\n<b>&lt;DIALECT&gt;</b> New Testament of Pastalie\n
gat	[gatto]\n▪<i><font face='mono'>n.</font></i>\ncurse: <i><font color='#404040'>Ciel fusya en gat ftt&nbsp;&nbsp;—<font size='1'>EXEC_VIENA/.</font></font></i>\n\n<b>&lt;DIALECT&gt;</b> Central Standard Note\n
gatyunla	[gachunra]\n▪<i><font face='mono'>n.</font></i>\ncursed land, hell\n\n<b>&lt;DIALECT&gt;</b> Cult Ciel Note\n
gatyuny	[gachuni]\n▪<i><font face='mono'>n.</font></i>\ncurse\n\n<b>&lt;DIALECT&gt;</b> Cult Ciel Note\n
gaunji	[?]\n▪<i><font face='mono'>v.</font></i>\ntorment, torture: <i><font color='#404040'>en whai pauwel gaunji yasra whou na cenjue sor tou zuieg&nbsp;&nbsp;—<font size='1'>EXEC_CHRONICLE KEY</font></font></i>\n\n<b>&lt;DIALECT&gt;</b> Unknown [Unofficial]\n
gauto	[?]\n▪<i><font face='mono'>noun</font></i>\ndark skies, overcast, dark clouds \n\n<b>&lt;DIALECT&gt;</b> Unknown [Unofficial]\n
gauv	[?]\n▪<i><font face='mono'>n.</font></i>\nsin, blame\n\n<b>&lt;DIALECT&gt;</b> Unknown [Unofficial]\n
gauzewiga	[gaunze^vi^ga]\n▪<i><font face='mono'>v.</font></i>\ndespair: <i><font color='#404040'>Harr re heighte der gauzewiga oz ciel&nbsp;&nbsp;—<font size='1'>EXEC_METAFALICA/.</font></font></i>\n\n<b>&lt;DIALECT&gt;</b> Metafalss Note\n
gaya	[gaya]\n▪<i><font face='mono'>E.s. III</font></i>\nI never want to go back to how I was before: <i><font color='#404040'>Rrha cyuie gaya na ieeya crushue anw dornpica rhaplanca&nbsp;&nbsp;—<font size='1'>EXEC_HIBERNATION/.</font></font></i>\n\n<b>&lt;DIALECT&gt;</b> Central Standard Note\n
geeow	[gio]\n▪<i><font face='mono'>n./v.</font></i>\noath, vow, resolve\n\n<b>&lt;DIALECT&gt;</b> Central Standard Note\n
getrra	[gettora]\n▪<i><font face='mono'>adj.</font></i>\ndirty, impure: <i><font color='#404040'>Rrha ki ra hymme PAJA yor getrra en gott wi gyas&nbsp;&nbsp;—<font size='1'>EXEC_PURGER/.#Aurica extracting</font></font></i>\n\n<b>&lt;DIALECT&gt;</b> Central Standard Note\n
gfine	[?]\n▪<i><font face='mono'>noun</font></i>\ntime \n\n<b>&lt;DIALECT&gt;</b> Unknown [Unofficial]\n
gigeadeth	[gigadeisu]\n▪<i><font face='mono'>adj./n.</font></i>\nsteel, iron (Note: It can be used both as an adjective and a noun): <i><font color='#404040'>Ween colgen fayra Race mea wis gigeadeth zeeth tie yor&nbsp;&nbsp;—<font size='1'>EXEC_DESPEDIA/.</font></font></i>\n\n<b>&lt;DIALECT&gt;</b> Central Standard Note\n
giue	[?]\n▪<i><font face='mono'>n.</font></i>\nbody: <i><font color='#404040'>Wee ki ra araus tes soare en giue mea iem&nbsp;&nbsp;—<font size='1'>EXEC_CHRONICLE KEY</font></font></i>\n\n<b>&lt;DIALECT&gt;</b> Unknown [Unofficial]\n
giz	[?]\n▪<i><font face='mono'>n./v.</font></i>\nfear, dread, terror: <i><font color='#404040'>vega ouvyu giz sphaela&nbsp;&nbsp;—<font size='1'>METHOD_REPLEKIA/.</font></font></i>\n\n<b>&lt;DIALECT&gt;</b> Unknown [Unofficial]\n
gkgul	[gukkuru]\n▪<i><font face='mono'>adj.</font></i>\ncracked: <i><font color='#404040'>x. rre rhaplanca t.n.m.n. poe ess gkgul doodu&nbsp;&nbsp;—<font size='1'>METHOD_METAFALICA/.</font></font></i>\n\n<b>&lt;DIALECT&gt;</b> New Testament of Pastalie\n
glansee	[guranzui]\n▪<i><font face='mono'>adj.</font></i>\ndivine, exalted (Note: adding "LYA" before it changes its meaning to "God").: <i><font color='#404040'>x. rre urgn zz t.k.d. ut glansee&nbsp;&nbsp;—<font size='1'>EXEC_over.METHOD_SUBLIMATION/.~omness chs ciel sos infel</font></font></i>\n\n<b>&lt;DIALECT&gt;</b> New Testament of Pastalie\n
glasden	[gurasuden]\n▪<i><font face='mono'>adj.</font></i>\nhighest, supreme, most: <i><font color='#404040'>Was yea ra chs hymmnos la glasden yehah&nbsp;&nbsp;—<font size='1'>EXEC_SOL=FAGE/.</font></font></i>\n\n<b>&lt;DIALECT&gt;</b> Metafalss Note\n
goa	[goa]\n▪<i><font face='mono'>conj.</font></i>\nonly ~ (it's used in the same way as the English "only"): <i><font color='#404040'>x. harr v.t. goa balduo sphaela&nbsp;&nbsp;—<font size='1'>METHOD_REPLEKIA/.</font></font></i>\n\n<b>&lt;DIALECT&gt;</b> New Testament of Pastalie\n
gool	[gu^ru]\n▪<i><font face='mono'>adjective</font></i>\nstarved, parched \n\n<b>&lt;DIALECT&gt;</b> Central Standard Note\n
got	[gotto]\n▪<i><font face='mono'>v.</font></i>\nget, obtain: <i><font color='#404040'>Rrha yea ra rinc en echrra yor rre walasye jyel got ieeya&nbsp;&nbsp;—<font size='1'>Singing Hill - Harmonics FRELIA </font></font></i>\n\n<b>&lt;DIALECT&gt;</b> Cult Ciel Note\n
gott	[gotto]\n▪<i><font face='mono'>v</font></i>\nGet off! Go away! (dirty feeling): <i><font color='#404040'>Rrha ki ra hymme PAJA yor getrra en gott wi gyas&nbsp;&nbsp;—<font size='1'>EXEC_PURGER/.#Aurica extracting</font></font></i>\n\n<b>&lt;DIALECT&gt;</b> Central Standard Note\n
govan	[?]\n▪<i><font face='mono'>adj.</font></i>\nviolent, excited, vehement, intense: <i><font color='#404040'>x. rre govan en wefa sarla f.w.r.n. du dje&nbsp;&nbsp;—<font size='1'>METHOD_METAFALICA/.</font></font></i>\n\n<b>&lt;DIALECT&gt;</b> Pastalie [Unofficial]\n
govaz	[go^vazu]\n▪<i><font face='mono'>n.</font></i>\nfiancee\n\n<b>&lt;DIALECT&gt;</b> Cult Ciel Note\n
gral	[guraru]\n▪<i><font face='mono'>adj.</font></i>\nall of, entire\n\n<b>&lt;DIALECT&gt;</b> New Testament of Pastalie\n
gran	[guran]\n▪<i><font face='mono'>v.</font></i>\nopen the curtain: <i><font color='#404040'>Rrha ki ga gran wael wassa&nbsp;&nbsp;—<font size='1'>EXEC_SOL=FAGE/.</font></font></i>\n\n<b>&lt;DIALECT&gt;</b> Cult Ciel Note\n
grandee	[gurandeie^]\n▪<i><font face='mono'>n.</font></i>\nguardian: <i><font color='#404040'>Wee ki ra chs Chronicle Key en grandee sos dius yor&nbsp;&nbsp;—<font size='1'>EXEC_CHRONICLE KEY</font></font></i>\n\n<b>&lt;DIALECT&gt;</b> Metafalss Note\n
grandus	[gurandousu]\n▪<i><font face='mono'>v.</font></i>\ndefend, protect: <i><font color='#404040'>Forgandal ar dius near grandus mea der dilete&nbsp;&nbsp;—<font size='1'>Singing Hill - Harmonics FRELIA </font></font></i>\n\n<b>&lt;DIALECT&gt;</b> Metafalss Note\n
granme	[guranme]\n▪<i><font face='mono'>E.s. II</font></i>\nWishing to protect someone, courage: <i><font color='#404040'>Den harr granme irs pitod enrer&nbsp;&nbsp;—<font size='1'>EXEC_METAFALICA/.</font></font></i>\n\n<b>&lt;DIALECT&gt;</b> Central Standard Note\n
grave	[gureivu]\n▪<i><font face='mono'>n.</font></i>\nmountain recesses, interior (of a building, etc.)\n\n<b>&lt;DIALECT&gt;</b> Cult Ciel Note\n
grlanza	[gurantsua]\n▪<i><font face='mono'>v.</font></i>\ndance: <i><font color='#404040'>chs plina en grlanza art fhyu&nbsp;&nbsp;—<font size='1'>EXEC_over.METHOD_SUBLIMATION/.~omness chs ciel sos infel</font></font></i>\n\n<b>&lt;DIALECT&gt;</b> Central Standard Note\n
grow	[?]\n▪<i><font face='mono'>adjective</font></i>\ninsolent, arrogant \n\n<b>&lt;DIALECT&gt;</b> Unknown [Unofficial]\n
grrena	[gurena]\n▪<i><font face='mono'>adj./n.</font></i>\ngreen (Note: It can be used both as a noun and adjective. As a noun, it's used for non-green plants): <i><font color='#404040'>celetille burle bautifal grrena&nbsp;&nbsp;—<font size='1'>Colors~SEN~Will This Flower Bloom? 	</font></font></i>\n\n<b>&lt;DIALECT&gt;</b> Central Standard Note\n
grruw	[guruu]\n▪<i><font face='mono'>v.</font></i>\nraise, grow up: <i><font color='#404040'>Was yea ra grruw heetha&nbsp;&nbsp;—<font size='1'>EXEC_HIBERNATION/.</font></font></i>\n\n<b>&lt;DIALECT&gt;</b> Central Standard Note\n
guard	[guarudo]\n▪<i><font face='mono'>n.</font></i>\nprotection\n\n<b>&lt;DIALECT&gt;</b> Central Standard Note\n
guatrz	[go^tsu]\n▪<i><font face='mono'>n.</font></i>\nanger, hatred: <i><font color='#404040'>Rrha i ga guatrz gyas guatrz gyas&nbsp;&nbsp;—<font size='1'>EXEC_HIBERNATION/.</font></font></i>\n\n<b>&lt;DIALECT&gt;</b> Central Standard Note\n
guaysu	[guaisu]\n▪<i><font face='mono'>v.</font></i>\nhang one's head (in shame, etc.): <i><font color='#404040'>Was nyasri ga hieg yorra guaysu&nbsp;&nbsp;—<font size='1'>EXEC_over.METHOD_SUBLIMATION/.~omness chs ciel sos infel</font></font></i>\n\n<b>&lt;DIALECT&gt;</b> Central Standard Note\n
guol	[guoru]\n▪<i><font face='mono'>v.</font></i>\nclose (a door, etc.)\n\n<b>&lt;DIALECT&gt;</b> Central Standard Note\n
guwo	[guuo]\n▪<i><font face='mono'>E.s. II</font></i>\nanger, resentment: <i><font color='#404040'>faf mea guwo mea&nbsp;&nbsp;—<font size='1'>EXEC_SPHILIA/.</font></font></i>\n\n<b>&lt;DIALECT&gt;</b> Central Standard Note\n
gyaje	[gyajie]\n▪<i><font face='mono'>n.</font></i>\nerror, mistake: <i><font color='#404040'>Was ki ra na fogabe anw sial gyaje&nbsp;&nbsp;—<font size='1'>EXEC_over.METHOD_SUBLIMATION/.~omness chs ciel sos infel</font></font></i>\n\n<b>&lt;DIALECT&gt;</b> Central Standard Note\n
gyajlee	[gyajiere]\n▪<i><font face='mono'>n.</font></i>\ncriminal, sinner: <i><font color='#404040'>Wassee fatere gyajlee deata&nbsp;&nbsp;—<font size='1'>EXEC_over.METHOD_SUBLIMATION/.~omness chs ciel sos infel</font></font></i>\n\n<b>&lt;DIALECT&gt;</b> Cult Ciel Note\n
gyas	[gyasu]\n▪<i><font face='mono'>n.</font></i>\nevil spirit, bad component: <i><font color='#404040'>Rrha ki ra hymme PAJA yor getrra en gott wi gyas&nbsp;&nbsp;—<font size='1'>EXEC_PURGER/.#Aurica extracting</font></font></i>\n\n<b>&lt;DIALECT&gt;</b> Central Standard Note\n
gyen	[jien]\n▪<i><font face='mono'>v.</font></i>\nspin, craft, create magic: <i><font color='#404040'>Was yea ra enne en crushue gyen METAFALICA ee sosar&nbsp;&nbsp;—<font size='1'>Singing Hill - Harmonics FRELIA </font></font></i>\n\n<b>&lt;DIALECT&gt;</b> Cult Ciel Note\n
gyenel	[jieneru]\n▪<i><font face='mono'>n.</font></i>\nwizard, mage, sorcerer\n\n<b>&lt;DIALECT&gt;</b> Cult Ciel Note\n
gyengyat	[jienjatto]\n▪<i><font face='mono'>v.</font></i>\ndevour, lustfully eat\n\n<b>&lt;DIALECT&gt;</b> Cult Ciel Note\n
gyuss	[gyusu]\n▪<i><font face='mono'>n.</font></i>\nembrace, hug: <i><font color='#404040'>Tasyue anw gyuss en yosyua yor&nbsp;&nbsp;—<font size='1'>EXEC_over.METHOD_SUBLIMATION/.~omness chs ciel sos infel</font></font></i>\n\n<b>&lt;DIALECT&gt;</b> Central Standard Note\n
gyusya	[gyusha]\n▪<i><font face='mono'>v.</font></i>\nrule, control: <i><font color='#404040'>gott getrra dsier gyusya mea&nbsp;&nbsp;—<font size='1'>Colors~SEN~Will This Flower Bloom? 	</font></font></i>\n\n<b>&lt;DIALECT&gt;</b> Central Standard Note\n
h.k.t.t.	[hakuto]\n▪<i><font face='mono'>E.v.</font></i>\nembrace, hug\n\n<b>&lt;DIALECT&gt;</b> New Testament of Pastalie\n
h.l.s.s.	[furusu]\n▪<i><font face='mono'>E.v.</font></i>\ngrieve, sigh: <i><font color='#404040'>x. rre f.r.l. h.l.s.s. ayulsa dazua&nbsp;&nbsp;—<font size='1'>METHOD_REPLEKIA/.</font></font></i>\n\n<b>&lt;DIALECT&gt;</b> New Testament of Pastalie\n
h.m.m.r.	[fumuru]\n▪<i><font face='mono'>E.v.</font></i>\nsing: <i><font color='#404040'>h.m.m.r. et&nbsp;&nbsp;—<font size='1'>jy ra cc ci ce je xa jy r acc ci ce je xa rcc jy ra cc ar foul</font></font></i>\n\n<b>&lt;DIALECT&gt;</b> New Testament of Pastalie\n
h.p.p.	[fupu]\n▪<i><font face='mono'>E.v.</font></i>\nthink, feel\n\n<b>&lt;DIALECT&gt;</b> New Testament of Pastalie\n
h.p.ps.	[fuppusu]\n▪<i><font face='mono'>E.v.</font></i>\nhave (someone) on one's mind\n\n<b>&lt;DIALECT&gt;</b> New Testament of Pastalie\n
h.r.n.t.	[hanto]\n▪<i><font face='mono'>E.v.</font></i>\ngo on a journey\n\n<b>&lt;DIALECT&gt;</b> New Testament of Pastalie\n
h.w.s.s.	[fuusu]\n▪<i><font face='mono'>E.v.</font></i>\ngrow, mature: <i><font color='#404040'>x. rre poe h.w.s.s. ut varda&nbsp;&nbsp;—<font size='1'>METHOD_METAFALICA/.</font></font></i>\n\n<b>&lt;DIALECT&gt;</b> New Testament of Pastalie\n
haf	[hafu]\n▪<i><font face='mono'>v.</font></i>\nhave, own, hold: <i><font color='#404040'>Was num ra haf ar ciel&nbsp;&nbsp;—<font size='1'>Singing Hill</font></font></i>\n\n<b>&lt;DIALECT&gt;</b> Central Standard Note\n
handeres	[henderesu]\n▪<i><font face='mono'>n./v.</font></i>\ndefeat, loss\n\n<b>&lt;DIALECT&gt;</b> Central Standard Note\n
hao	[hao]\n▪<i><font face='mono'>adj.</font></i>\nabove, superior\n\n<b>&lt;DIALECT&gt;</b> Central Standard Note\n
harmon	[ha^mon]\n▪<i><font face='mono'>v.</font></i>\ndo ~ together (in great numbers): <i><font color='#404040'>Wee yea ra hymme hymmnos harmon en syast et wi powel&nbsp;&nbsp;—<font size='1'>Singing Hill - Harmonics FRELIA </font></font></i>\n\n<b>&lt;DIALECT&gt;</b> Central Standard Note\n
harphe	[harufe]\n▪<i><font face='mono'>n.</font></i>\nmorning: <i><font color='#404040'>x. sorr a.u.k. zess l.l.n. anw aje harphe&nbsp;&nbsp;—<font size='1'>METHOD_IMPLANTA/.</font></font></i>\n\n<b>&lt;DIALECT&gt;</b> New Testament of Pastalie\n
harr	[haruru]\n▪<i><font face='mono'>pro.</font></i>\nshe: <i><font color='#404040'>x. harr h.m.m.r. eje&nbsp;&nbsp;—<font size='1'>METHOD_REPLEKIA/.</font></font></i>\n\n<b>&lt;DIALECT&gt;</b> Central Standard Note\n
harra	[harurura]\n▪<i><font face='mono'>pro.</font></i>\nshe (plural)\n\n<b>&lt;DIALECT&gt;</b> Central Standard Note\n
hars	[harusu]\n▪<i><font face='mono'>n.</font></i>\nher (plural)\n\n<b>&lt;DIALECT&gt;</b> Central Standard Note\n
hartes	[ha^tesu]\n▪<i><font face='mono'>v.</font></i>\nlove: <i><font color='#404040'>y.z.t. za rre vega f.s. t.k.d. ag zz t.k.d. tie hartes yor&nbsp;&nbsp;—<font size='1'>METHOD_METAFALICA/.</font></font></i>\n\n<b>&lt;DIALECT&gt;</b> Cult Ciel Note\n
harton	[ha^ton]\n▪<i><font face='mono'>n.</font></i>\nlove: <i><font color='#404040'>Wee yea ra reen harton yos warma hynne reen yos warma hynne&nbsp;&nbsp;—<font size='1'>Eternally Bonded</font></font></i>\n\n<b>&lt;DIALECT&gt;</b> Central Standard Note\n
has	[hasu]\n▪<i><font face='mono'>n.</font></i>\nher: <i><font color='#404040'>Rre fandel heighte has en plina&nbsp;&nbsp;—<font size='1'>EXEC_METAFALICA/.</font></font></i>\n\n<b>&lt;DIALECT&gt;</b> Central Standard Note\n
hasyu	[hashu]\n▪<i><font face='mono'>n.</font></i>\nfish: <i><font color='#404040'>chs hasyu en zassyen der sielp&nbsp;&nbsp;—<font size='1'>EXEC_over.METHOD_SUBLIMATION/.~omness chs ciel sos infel</font></font></i>\n\n<b>&lt;DIALECT&gt;</b> Central Standard Note\n
heath	[hi^su]\n▪<i><font face='mono'>adj.</font></i>\nscalding hot\n\n<b>&lt;DIALECT&gt;</b> Central Standard Note\n
heetha	[hii^sa]\n▪<i><font face='mono'>adj./n.</font></i>\nhealth, healthy: <i><font color='#404040'>Was yea ra grruw heetha&nbsp;&nbsp;—<font size='1'>EXEC_HIBERNATION/.</font></font></i>\n\n<b>&lt;DIALECT&gt;</b> Central Standard Note\n
heighte	[heite]\n▪<i><font face='mono'>v.</font></i>\ninjure, wound: <i><font color='#404040'>gott denera heighte mea&nbsp;&nbsp;—<font size='1'>Colors~SEN~Will This Flower Bloom? 	</font></font></i>\n\n<b>&lt;DIALECT&gt;</b> Metafalss Note\n
hellei	\n▪<i><font face='mono'>E.s. II</font></i>\n(unknown meaning): <i><font color='#404040'>Fou hellei ga&nbsp;&nbsp;—<font size='1'>EXEC_HARMONIOUS_FUSION/.</font></font></i>\n\n<b>&lt;DIALECT&gt;</b> \n
her	[ia]\n▪<i><font face='mono'>pro.</font></i>\nthis\n\n<b>&lt;DIALECT&gt;</b> Central Standard Note\n
here	[ia]\n▪<i><font face='mono'>adv.</font></i>\nhere: <i><font color='#404040'>Den here irs ar vinan frawr ween titilia shellan&nbsp;&nbsp;—<font size='1'>EXEC_HARMONIOUS_FUSION/.</font></font></i>\n\n<b>&lt;DIALECT&gt;</b> Central Standard Note\n
herr	[heruru]\n▪<i><font face='mono'>pro.</font></i>\nhe: <i><font color='#404040'>f.w.r.n. yor herr en harr mea infel&nbsp;&nbsp;—<font size='1'>EXEC_with.METHOD_METAFALICA/.</font></font></i>\n\n<b>&lt;DIALECT&gt;</b> Central Standard Note\n
herra	[herurura]\n▪<i><font face='mono'>pro.</font></i>\nhe (plural): <i><font color='#404040'>herra pagle harr riomo hueaf&nbsp;&nbsp;—<font size='1'>EXEC_METAFALICA/.</font></font></i>\n\n<b>&lt;DIALECT&gt;</b> Central Standard Note\n
hers	[he rusu]\n▪<i><font face='mono'>n.</font></i>\nhim (plural)\n\n<b>&lt;DIALECT&gt;</b> Central Standard Note\n
hes	[hesu]\n▪<i><font face='mono'>n.</font></i>\nhim\n\n<b>&lt;DIALECT&gt;</b> Central Standard Note\n
hieg	[hi^gu]\n▪<i><font face='mono'>adj./v.</font></i>\nsad, to be sad: <i><font color='#404040'>Was nyasri ga hieg yorra guaysu&nbsp;&nbsp;—<font size='1'>EXEC_over.METHOD_SUBLIMATION/.~omness chs ciel sos infel</font></font></i>\n\n<b>&lt;DIALECT&gt;</b> Central Standard Note\n
hierle	[heiarure^]\n▪<i><font face='mono'>adj./v.</font></i>\nsad, to be sad: <i><font color='#404040'>tasyue yorr yehar elle fandel hierle&nbsp;&nbsp;—<font size='1'>EXEC_HARMONIOUS_FUSION/.</font></font></i>\n\n<b>&lt;DIALECT&gt;</b> Metafalss Note\n
hiew	[hi^u]\n▪<i><font face='mono'>n.</font></i>\nsadness\n\n<b>&lt;DIALECT&gt;</b> New Testament of Pastalie\n
hiewi	[hi^ui]\n▪<i><font face='mono'>adj.</font></i>\nheart-breaking, sad\n\n<b>&lt;DIALECT&gt;</b> New Testament of Pastalie\n
hiralg	[?]\n▪<i><font face='mono'>n.</font></i>\nthirst: <i><font color='#404040'>x. rre qejyu ssvid hiralg ag xevxl&nbsp;&nbsp;—<font size='1'>METHOD_METAFALICA/.</font></font></i>\n\n<b>&lt;DIALECT&gt;</b> Unknown [Unofficial]\n
hopb	[hoppu]\n▪<i><font face='mono'>n.</font></i>\nheart, mind (when presenting it as a phenomenon): <i><font color='#404040'>innna ar hopb syec mea ya ya&nbsp;&nbsp;—<font size='1'>Singing Hill</font></font></i>\n\n<b>&lt;DIALECT&gt;</b> Cult Ciel Note\n
houd	[houdo]\n▪<i><font face='mono'>v.</font></i>\nembrace, hug: <i><font color='#404040'>Was yea ra ieeya houd&nbsp;&nbsp;—<font size='1'>Eternally Bonded</font></font></i>\n\n<b>&lt;DIALECT&gt;</b> Central Standard Note\n
how	[?]\n▪<i><font face='mono'>conj.</font></i>\nhow, like ~: <i><font color='#404040'>sacra how clalliss&nbsp;&nbsp;—<font size='1'>EXEC_HARMONIOUS_FUSION/.</font></font></i>\n\n<b>&lt;DIALECT&gt;</b> Unknown [Unofficial]\n
hueaf	[hyafu]\n▪<i><font face='mono'>adj./n.</font></i>\nfutile, useless, worthless, waste of effort: <i><font color='#404040'>herra pagle harr riomo hueaf&nbsp;&nbsp;—<font size='1'>EXEC_METAFALICA/.</font></font></i>\n\n<b>&lt;DIALECT&gt;</b> Central Standard Note\n
hyear	[iea , ya]\n▪<i><font face='mono'>int.</font></i>\nhey, you (to get someone's attention) (Note: Used both for admiration and calling. It can be pronounced as "hyear" or "ya", but generally, "ya" is the only way used because of being faster to pronounce): <i><font color='#404040'>Presia chanti ee tes titilia manaf hyear&nbsp;&nbsp;—<font size='1'>Colors~SEN~Will This Flower Bloom? 	</font></font></i>\n\n<b>&lt;DIALECT&gt;</b> Central Standard Note\n
hyma	[hyuma]\n▪<i><font face='mono'>v.</font></i>\nlisten (to words)\n\n<b>&lt;DIALECT&gt;</b> Central Standard Note\n
hymma	[hyunma]\n▪<i><font face='mono'>n.</font></i>\nsmall bird (Note: This word originally meant "music player", and it originated from "hymme").: <i><font color='#404040'>sara dorn fhyu hymma&nbsp;&nbsp;—<font size='1'>Singing Hill</font></font></i>\n\n<b>&lt;DIALECT&gt;</b> Central Standard Note\n
hymme	[hyumu]\n▪<i><font face='mono'>v./n.</font></i>\nsing, play (a instrument), resonate (Note: It can be also used as a noun. In that case, it would mean "waves", "waving", and "vibration of formless things").: <i><font color='#404040'>Wee ki ra ene rre sor hymme ar ciel en rre hymmnos ee powel&nbsp;&nbsp;—<font size='1'>Singing Hill - Harmonics FRELIA </font></font></i>\n\n<b>&lt;DIALECT&gt;</b> Central Standard Note\n
hymmne	[hyumune]\n▪<i><font face='mono'>n.</font></i>\nsound waves, tune, melody (Note: Has lighter connotations than Hymmnos. It actually is used for talking about songs in a more superficial form).: <i><font color='#404040'>chs hymmne&nbsp;&nbsp;—<font size='1'>Singing Hill</font></font></i>\n\n<b>&lt;DIALECT&gt;</b> Central Standard Note\n
hymmnos	[hyumunosu]\n▪<i><font face='mono'>n.</font></i>\nsong, Hymmnos: <i><font color='#404040'>Wee ki ra ene rre sor hymme ar ciel en rre hymmnos ee powel&nbsp;&nbsp;—<font size='1'>Singing Hill - Harmonics FRELIA </font></font></i>\n\n<b>&lt;DIALECT&gt;</b> Central Standard Note\n
hynne	[hyun]\n▪<i><font face='mono'>n.</font></i>\nvoice: <i><font color='#404040'>Wee yea ra reen harton yos warma hynne reen yos warma hynne&nbsp;&nbsp;—<font size='1'>Eternally Bonded</font></font></i>\n\n<b>&lt;DIALECT&gt;</b> Central Standard Note\n
hyzik	[fijiku]\n▪<i><font face='mono'>n.</font></i>\nbody: <i><font color='#404040'>slepir tes pauwel an hyzik&nbsp;&nbsp;—<font size='1'>EXEC_CHRONICLE KEY</font></font></i>\n\n<b>&lt;DIALECT&gt;</b> Alpha Note (EOLIA)\n
i	[i]\n▪<i><font face='mono'>E.s. II</font></i>\nimpatience: <i><font color='#404040'>Was i ra presia fogabe marta presia fogabe marta&nbsp;&nbsp;—<font size='1'>Eternally Bonded</font></font></i>\n\n<b>&lt;DIALECT&gt;</b> Central Standard Note\n
iasien	[iashien]\n▪<i><font face='mono'>n.</font></i>\nmorning dew: <i><font color='#404040'>Wee yea ra rre lyafre famfa en jass anw iasien&nbsp;&nbsp;—<font size='1'>EXEC_over.METHOD_SUBLIMATION/.~omness chs ciel sos infel</font></font></i>\n\n<b>&lt;DIALECT&gt;</b> Cult Ciel Note\n
ides	[idesu]\n▪<i><font face='mono'>n.</font></i>\npast: <i><font color='#404040'>ides loss bautifal sarla&nbsp;&nbsp;—<font size='1'>EXEC_SPHILIA/.</font></font></i>\n\n<b>&lt;DIALECT&gt;</b> Central Standard Note\n
idesy	[ideshi^]\n▪<i><font face='mono'>adj.</font></i>\nof the past: <i><font color='#404040'>art crudea en raklya art idesy memora&nbsp;&nbsp;—<font size='1'>EXEC_over.METHOD_SUBLIMATION/.~omness chs ciel sos infel</font></font></i>\n\n<b>&lt;DIALECT&gt;</b> Central Standard Note\n
ieeya	[i^ya]\n▪<i><font face='mono'>n.</font></i>\nhope, wish: <i><font color='#404040'>Rrha yea ra rinc en echrra yor rre walasye jyel got ieeya&nbsp;&nbsp;—<font size='1'>Singing Hill - Harmonics FRELIA </font></font></i>\n\n<b>&lt;DIALECT&gt;</b> Central Standard Note\n
iem	[iemu]\n▪<i><font face='mono'>n.</font></i>\nnow: <i><font color='#404040'>x. rre vonn papana f.p.n. ut kvyeire qoga iem&nbsp;&nbsp;—<font size='1'>EXEC_over.METHOD_SUBLIMATION/.~lamenza</font></font></i>\n\n<b>&lt;DIALECT&gt;</b> Metafalss Note\n
infel	[inferu]\n▪<i><font face='mono'>n.</font></i>\nlove ( Note: "infel yor" means "thank you"): <i><font color='#404040'>fandel rosa fandel rosa yorr infel&nbsp;&nbsp;—<font size='1'>EXEC_HARMONIOUS_FUSION/.</font></font></i>\n\n<b>&lt;DIALECT&gt;</b> Metafalss Note\n
inferiare	[inferia^re]\n▪<i><font face='mono'>adj.</font></i>\nbeloved: <i><font color='#404040'>irs jam inferiare yor yehar jyel fusya&nbsp;&nbsp;—<font size='1'>Singing Hill - Harmonics FRELIA </font></font></i>\n\n<b>&lt;DIALECT&gt;</b> Metafalss Note\n
ini	[ini]\n▪<i><font face='mono'>v.</font></i>\ninitialize, purify: <i><font color='#404040'>Rrha ki ra tie yor ini en nha&nbsp;&nbsp;—<font size='1'>Singing Hill</font></font></i>\n\n<b>&lt;DIALECT&gt;</b> Cult Ciel Note\n
innna	[inna]\n▪<i><font face='mono'>n.</font></i>\ninside (of the Soulspace), within one's heart: <i><font color='#404040'>innna ar hopb syec mea ya ya&nbsp;&nbsp;—<font size='1'>Singing Hill</font></font></i>\n\n<b>&lt;DIALECT&gt;</b> Cult Ciel Note\n
irs	[irusu]\n▪<i><font face='mono'>v.</font></i>\nexist: <i><font color='#404040'>irs jam inferiare yor yehar jyel fusya&nbsp;&nbsp;—<font size='1'>Singing Hill - Harmonics FRELIA </font></font></i>\n\n<b>&lt;DIALECT&gt;</b> Central Standard Note\n
j.d.r.	[?]\n▪<i><font face='mono'>E.v.</font></i>\naprehend, capture\n\n<b>&lt;DIALECT&gt;</b> Pastalie [Unofficial]\n
j.l.j.	[jierujie]\n▪<i><font face='mono'>E.v.</font></i>\ncapture, adhere, take in\n\n<b>&lt;DIALECT&gt;</b> New Testament of Pastalie\n
j.l.r.	[ju^ru]\n▪<i><font face='mono'>E.v.</font></i>\ncalm down, return to one's self\n\n<b>&lt;DIALECT&gt;</b> New Testament of Pastalie\n
j.w.	[jieu]\n▪<i><font face='mono'>E.v.</font></i>\nentrust\n\n<b>&lt;DIALECT&gt;</b> New Testament of Pastalie\n
j.z.t.	[jiezuto]\n▪<i><font face='mono'>E.v.</font></i>\nexecute, invoke: <i><font color='#404040'>j.z.t.&nbsp;&nbsp;—<font size='1'>jy ra cc ci ce je xa jy r acc ci ce je xa rcc jy ra cc ar foul</font></font></i>\n\n<b>&lt;DIALECT&gt;</b> New Testament of Pastalie\n
jam	[jamu]\n▪<i><font face='mono'>adv.</font></i>\ntogether: <i><font color='#404040'>irs jam inferiare yor yehar jyel fusya&nbsp;&nbsp;—<font size='1'>Singing Hill - Harmonics FRELIA </font></font></i>\n\n<b>&lt;DIALECT&gt;</b> Central Standard Note\n
jambea	[janbea]\n▪<i><font face='mono'>n.</font></i>\nfoot, leg: <i><font color='#404040'>en chess won vinan jambea mea gigeadeth zeeth tie yor&nbsp;&nbsp;—<font size='1'>EXEC_DESPEDIA/.</font></font></i>\n\n<b>&lt;DIALECT&gt;</b> Central Standard Note\n
jass	[jasu]\n▪<i><font face='mono'>v.</font></i>\nseek, request, wish for: <i><font color='#404040'>Wee yea ra rre lyafre famfa en jass anw iasien&nbsp;&nbsp;—<font size='1'>EXEC_over.METHOD_SUBLIMATION/.~omness chs ciel sos infel</font></font></i>\n\n<b>&lt;DIALECT&gt;</b> Central Standard Note\n
jastil	[?]\n▪<i><font face='mono'>v.</font></i>\nCome!, Let's go!\n\n<b>&lt;DIALECT&gt;</b> Unknown [Unofficial]\n
jefea	[?]\n▪<i><font face='mono'>adj.</font></i>\nlamenting, grieving\n\n<b>&lt;DIALECT&gt;</b> Unknown [Unofficial]\n
jenge	[jienjie]\n▪<i><font face='mono'>n.</font></i>\nenemy, rival, opponent\n\n<b>&lt;DIALECT&gt;</b> Cult Ciel Note\n
jenhah	[jienha^]\n▪<i><font face='mono'>n.</font></i>\ndisaster, misfortune: <i><font color='#404040'>jenhah gyas faf morto&nbsp;&nbsp;—<font size='1'>Colors~SEN~Will This Flower Bloom? 	</font></font></i>\n\n<b>&lt;DIALECT&gt;</b> Cult Ciel Note\n
jouee	[jue]\n▪<i><font face='mono'>n.</font></i>\nGod's power: <i><font color='#404040'>Rrha ki ra echcrra jouee Rrha ki ra chs hymmnos mea&nbsp;&nbsp;—<font size='1'>EXEC_METAFALICA/.</font></font></i>\n\n<b>&lt;DIALECT&gt;</b> Central Standard Note\n
jue	[?]\n▪<i><font face='mono'>n.</font></i>\nwater\n\n<b>&lt;DIALECT&gt;</b> Pastalie [Unofficial]\n
jyel	[jie^ru]\n▪<i><font face='mono'>E.s. II</font></i>\nloneliness: <i><font color='#404040'>irs jam inferiare yor yehar jyel fusya&nbsp;&nbsp;—<font size='1'>Singing Hill - Harmonics FRELIA </font></font></i>\n\n<b>&lt;DIALECT&gt;</b> Central Standard Note\n
k.f.k.k.	[?]\n▪<i><font face='mono'>E.v.</font></i>\nsneer, ridiculize, scorn\n\n<b>&lt;DIALECT&gt;</b> Pastalie [Unofficial]\n
k.r.	[kuru]\n▪<i><font face='mono'>E.v.</font></i>\nplay, frolic\n\n<b>&lt;DIALECT&gt;</b> New Testament of Pastalie\n
k.v.n.r.	[kevunru]\n▪<i><font face='mono'>E.v.</font></i>\nchallenge, defy\n\n<b>&lt;DIALECT&gt;</b> New Testament of Pastalie\n
k.v.r.	[?]\n▪<i><font face='mono'>E.v.</font></i>\ncover, wrap: <i><font color='#404040'>x. harr k.v.r. du qejyu&nbsp;&nbsp;—<font size='1'>METHOD_REPLEKIA/.</font></font></i>\n\n<b>&lt;DIALECT&gt;</b> Pastalie [Unofficial]\n
kajya	[kaja]\n▪<i><font face='mono'>adj.</font></i>\nnecessary, needed\n\n<b>&lt;DIALECT&gt;</b> New Testament of Pastalie\n
kapa	[kapa]\n▪<i><font face='mono'>n.</font></i>\nwater: <i><font color='#404040'>fayra en kapa weak en sheak&nbsp;&nbsp;—<font size='1'>EXEC_METAFALICA/.</font></font></i>\n\n<b>&lt;DIALECT&gt;</b> Cult Ciel Note\n
karf	[?]\n▪<i><font face='mono'>particle</font></i>\nthat, these \n\n<b>&lt;DIALECT&gt;</b> Unknown [Unofficial]\n
keen	[ke^n]\n▪<i><font face='mono'>v.</font></i>\nshine: <i><font color='#404040'>Fou yea ra waath ar ciel en hymme mea weel nepo en keen ar sar&nbsp;&nbsp;—<font size='1'>EXEC_PHANTASMAGORIA/.</font></font></i>\n\n<b>&lt;DIALECT&gt;</b> Central Standard Note\n
keenis	[kenisu]\n▪<i><font face='mono'>n.</font></i>\nradiance: <i><font color='#404040'>wassee forgandal dauane keenis na nozess&nbsp;&nbsp;—<font size='1'>EXEC_over.METHOD_SUBLIMATION/.~omness chs ciel sos infel</font></font></i>\n\n<b>&lt;DIALECT&gt;</b> Central Standard Note\n
keg	[kegu]\n▪<i><font face='mono'>n.</font></i>\nbranch: <i><font color='#404040'>ar w.r.l. du cia dn ryewa keg&nbsp;&nbsp;—<font size='1'>METHOD_METAFALICA/.</font></font></i>\n\n<b>&lt;DIALECT&gt;</b> New Testament of Pastalie\n
khal	[kuaru]\n▪<i><font face='mono'>v.</font></i>\nprotect, defend: <i><font color='#404040'>Was yea erra chs weak en khal anw yeal&nbsp;&nbsp;—<font size='1'>EXEC_VIENA/.</font></font></i>\n\n<b>&lt;DIALECT&gt;</b> Central Standard Note\n
ki	[ki]\n▪<i><font face='mono'>E.s. II</font></i>\nconcentration, focus, seriousness: <i><font color='#404040'>Wee ki ra ene rre sor hymme ar ciel en rre hymmnos ee powel&nbsp;&nbsp;—<font size='1'>Singing Hill - Harmonics FRELIA </font></font></i>\n\n<b>&lt;DIALECT&gt;</b> Central Standard Note\n
kiafa	[kiafa]\n▪<i><font face='mono'>v.</font></i>\nhear, listen: <i><font color='#404040'>Fou paks ra kiafa wael en chs frawr&nbsp;&nbsp;—<font size='1'>Chanting the Moon ~Tsukikanade~</font></font></i>\n\n<b>&lt;DIALECT&gt;</b> Metafalss Note\n
kiakkya	[?]\n▪<i><font face='mono'>noun</font></i>\nfriend \n\n<b>&lt;DIALECT&gt;</b> Unknown [Unofficial]\n
kiala	[?]\n▪<i><font face='mono'>adjective, noun</font></i>\ngold, golden \n\n<b>&lt;DIALECT&gt;</b> Unknown [Unofficial]\n
kieghl	\n▪<i><font face='mono'></font></i>\n(unknown meaning)\n\n<b>&lt;DIALECT&gt;</b> \n
kierre	[kie^rre]\n▪<i><font face='mono'>n.</font></i>\ninstant, moment: <i><font color='#404040'>Alroetsue kierre iem&nbsp;&nbsp;—<font size='1'>EXEC_HARMONIOUS</font></font></i>\n\n<b>&lt;DIALECT&gt;</b> Metafalss Note\n
kil	[kiru]\n▪<i><font face='mono'>v.</font></i>\nkill\n\n<b>&lt;DIALECT&gt;</b> Central Standard Note\n
knawa	[no^wa]\n▪<i><font face='mono'>v.</font></i>\nknow: <i><font color='#404040'>mea na knawa fandel&nbsp;&nbsp;—<font size='1'>Colors~SEN~Will This Flower Bloom? 	</font></font></i>\n\n<b>&lt;DIALECT&gt;</b> Central Standard Note\n
kneet	[ni^to]\n▪<i><font face='mono'>adj.</font></i>\nlate, be late, be too late: <i><font color='#404040'>Ma num ra tictim yorr wis kneet hueaf van yorr zaffur&nbsp;&nbsp;—<font size='1'>EXEC_DESPEDIA/.</font></font></i>\n\n<b>&lt;DIALECT&gt;</b> Central Standard Note\n
koffl	[?]\n▪<i><font face='mono'>verb</font></i>\ndrink \n\n<b>&lt;DIALECT&gt;</b> Unknown [Unofficial]\n
konla	[?]\n▪<i><font face='mono'>noun</font></i>\nlove \n\n<b>&lt;DIALECT&gt;</b> Unknown [Unofficial]\n
koora	[ko^ra]\n▪<i><font face='mono'>n.</font></i>\nstream: <i><font color='#404040'>hymme rol hymmer selena rol koora&nbsp;&nbsp;—<font size='1'>Chanting the Moon ~Tsukikanade~</font></font></i>\n\n<b>&lt;DIALECT&gt;</b> Central Standard Note\n
kouf	[ku^fu]\n▪<i><font face='mono'>n.</font></i>\nsigh: <i><font color='#404040'>en h.k.t.t nafan du ouwua kouf&nbsp;&nbsp;—<font size='1'>EXEC_over.METHOD_SUBLIMATION/.~omness chs ciel sos infel</font></font></i>\n\n<b>&lt;DIALECT&gt;</b> New Testament of Pastalie\n
ks	[kesu]\n▪<i><font face='mono'>v.</font></i>\ngive a hint: <i><font color='#404040'>Ma ki ga ks maya yor syec&nbsp;&nbsp;—<font size='1'>Singing Hill</font></font></i>\n\n<b>&lt;DIALECT&gt;</b> Cult Ciel Note\n
kuhle	[kyu^re]\n▪<i><font face='mono'>n.</font></i>\npoison: <i><font color='#404040'>llizz discest vine den kuhle&nbsp;&nbsp;—<font size='1'>The Heart Speaks</font></font></i>\n\n<b>&lt;DIALECT&gt;</b> Central Standard Note\n
kvvia	[?]\n▪<i><font face='mono'>n.</font></i>\nregrets, repentance: <i><font color='#404040'>w.w.j.n.c. syalea en zz kvvia&nbsp;&nbsp;—<font size='1'>METHOD_METAFALICA/.</font></font></i>\n\n<b>&lt;DIALECT&gt;</b> Unknown [Unofficial]\n
kvyeire	[?]\n▪<i><font face='mono'>n.</font></i>\nend, ending: <i><font color='#404040'>x. rre vonn papana f.p.n. ut kvyeire qoga iem&nbsp;&nbsp;—<font size='1'>EXEC_over.METHOD_SUBLIMATION/.~lamenza</font></font></i>\n\n<b>&lt;DIALECT&gt;</b> Unknown [Unofficial]\n
kyll	[?]\n▪<i><font face='mono'>v.</font></i>\ncut, detach: <i><font color='#404040'>Ween shellan re kyll fwal&nbsp;&nbsp;—<font size='1'>EXEC_SPHILIA/.</font></font></i>\n\n<b>&lt;DIALECT&gt;</b> Unknown [Unofficial]\n
l.k.k.	[?]\n▪<i><font face='mono'>E.v.</font></i>\nlook up at, admire: <i><font color='#404040'>x. harr l.k.k. maen&nbsp;&nbsp;—<font size='1'>METHOD_REPLEKIA/.</font></font></i>\n\n<b>&lt;DIALECT&gt;</b> Pastalie [Unofficial]\n
l.l.n.	[ririn]\n▪<i><font face='mono'>E.v.</font></i>\nbless: <i><font color='#404040'>x. sorr a.u.k. zess l.l.n. anw aje harphe&nbsp;&nbsp;—<font size='1'>METHOD_IMPLANTA/.</font></font></i>\n\n<b>&lt;DIALECT&gt;</b> New Testament of Pastalie\n
l.n.c.a.	[runka]\n▪<i><font face='mono'>E.v.</font></i>\ntie together, connect: <i><font color='#404040'>l.n.c.a. w.w.j.n.c. syec sphilar&nbsp;&nbsp;—<font size='1'>jy ra cc ci ce je xa jy r acc ci ce je xa rcc jy ra cc ar foul</font></font></i>\n\n<b>&lt;DIALECT&gt;</b> New Testament of Pastalie\n
la	[ra]\n▪<i><font face='mono'>pre.</font></i>\n*that* (used to emphasize, in front of a vowel sound): <i><font color='#404040'>Was yea ra chs hymmnos la glasden yehah&nbsp;&nbsp;—<font size='1'>EXEC_SOL=FAGE/.</font></font></i>\n\n<b>&lt;DIALECT&gt;</b> Central Standard Note\n
lamenza	[ramentsua^]\n▪<i><font face='mono'>n.</font></i>\nlament, grief: <i><font color='#404040'>tasyue anw ciel en dople anw omnis lamenza&nbsp;&nbsp;—<font size='1'>EXEC_over.METHOD_SUBLIMATION/.~omness chs ciel sos infel</font></font></i>\n\n<b>&lt;DIALECT&gt;</b> Metafalss Note\n
lamenzeo	[?]\n▪<i><font face='mono'>adjective, adverb</font></i>\nborne of laments, borne of grief \n\n<b>&lt;DIALECT&gt;</b> Unknown [Unofficial]\n
lapo	[rapo]\n▪<i><font face='mono'>v.</font></i>\nmeet (by chance), rendezvous\n\n<b>&lt;DIALECT&gt;</b> Cult Ciel Note\n
lasye	[rashie]\n▪<i><font face='mono'>n.</font></i>\nboy, young man\n\n<b>&lt;DIALECT&gt;</b> Central Standard Note\n
lau	[?]\n▪<i><font face='mono'>Emotion Sound (II)</font></i>\nfear, dread \n\n<b>&lt;DIALECT&gt;</b> Unknown [Unofficial]\n
lautyca	[?]\n▪<i><font face='mono'>verb</font></i>\nfall down \n\n<b>&lt;DIALECT&gt;</b> Unknown [Unofficial]\n
layy	[?]\n▪<i><font face='mono'>adj.</font></i>\nlie, false, imaginary: <i><font color='#404040'>llizz ene infel den layy&nbsp;&nbsp;—<font size='1'>The Heart Speaks</font></font></i>\n\n<b>&lt;DIALECT&gt;</b> Unknown [Unofficial]\n
leaff	[ri^fu]\n▪<i><font face='mono'>n.</font></i>\nbook, books, picture book: <i><font color='#404040'>Den na orviclle vis ween leaff&nbsp;&nbsp;—<font size='1'>EXEC_HARMONIOUS_FUSION/.</font></font></i>\n\n<b>&lt;DIALECT&gt;</b> Metafalss Note\n
leat	[ri^]\n▪<i><font face='mono'>v.</font></i>\nplay (instrument) (Note: It's very similar to the "singing" meaning of "hymme", but it's used in a much more figurative manner): <i><font color='#404040'>En hymmne leat mea en ciel&nbsp;&nbsp;—<font size='1'>Singing Hill</font></font></i>\n\n<b>&lt;DIALECT&gt;</b> Central Standard Note\n
lequera	[rikuuira]\n▪<i><font face='mono'>n.</font></i>\nGooddoer, good person: <i><font color='#404040'>Fou paks ra chs lequera en chs frawr&nbsp;&nbsp;—<font size='1'>Chanting the Moon ~Tsukikanade~</font></font></i>\n\n<b>&lt;DIALECT&gt;</b> Cult Ciel Note\n
lhasya	[?]\n▪<i><font face='mono'>verb</font></i>\nconnect, tie together \n\n<b>&lt;DIALECT&gt;</b> Unknown [Unofficial]\n
li	[ri]\n▪<i><font face='mono'>pre.</font></i>\n*that* (used to emphasize, in front of a consonant sound): <i><font color='#404040'>c.z. yor li yanje&nbsp;&nbsp;—<font size='1'>jy ra cc ci ce je xa jy r acc ci ce je xa rcc jy ra cc ar foul</font></font></i>\n\n<b>&lt;DIALECT&gt;</b> Central Standard Note\n
linen	[ri^nen]\n▪<i><font face='mono'>v.</font></i>\ntalk, recite\n\n<b>&lt;DIALECT&gt;</b> Cult Ciel Note\n
lir	[rairu]\n▪<i><font face='mono'>n.</font></i>\nlight\n\n<b>&lt;DIALECT&gt;</b> Alpha Note (EOLIA)\n
lirle	[rire^ru]\n▪<i><font face='mono'>n.</font></i>\nsummer\n\n<b>&lt;DIALECT&gt;</b> Cult Ciel Note\n
llizz	[rizu]\n▪<i><font face='mono'>adv.</font></i>\npossibly, maybe, perhaps: <i><font color='#404040'>llizz discest vine den kuhle&nbsp;&nbsp;—<font size='1'>The Heart Speaks</font></font></i>\n\n<b>&lt;DIALECT&gt;</b> Central Standard Note\n
lof	[rofu]\n▪<i><font face='mono'>n.</font></i>\nplace\n\n<b>&lt;DIALECT&gt;</b> Cult Ciel Note\n
lonfa	[?]\n▪<i><font face='mono'>n.</font></i>\nsoul: <i><font color='#404040'>presia aterra cremia sos viuy lonfa&nbsp;&nbsp;—<font size='1'>EXEC_CHRONICLE KEY</font></font></i>\n\n<b>&lt;DIALECT&gt;</b> Unknown [Unofficial]\n
lornya	[?]\n▪<i><font face='mono'>noun</font></i>\nhoney \n\n<b>&lt;DIALECT&gt;</b> Unknown [Unofficial]\n
loss	[?]\n▪<i><font face='mono'>adj.</font></i>\ndead, lost: <i><font color='#404040'>ides loss bautifal sarla&nbsp;&nbsp;—<font size='1'>EXEC_SPHILIA/.</font></font></i>\n\n<b>&lt;DIALECT&gt;</b> Unknown [Unofficial]\n
lulurnya	[?]\n▪<i><font face='mono'>noun</font></i>\njoy, happiness \n\n<b>&lt;DIALECT&gt;</b> Unknown [Unofficial]\n
lurrea	[ru^rrea]\n▪<i><font face='mono'>v.</font></i>\nfear: <i><font color='#404040'>van fandel wis lurrea&nbsp;&nbsp;—<font size='1'>EXEC_HARMONIOUS</font></font></i>\n\n<b>&lt;DIALECT&gt;</b> Metafalss Note\n
lusye	[ru^shie]\n▪<i><font face='mono'>n.</font></i>\nlight: <i><font color='#404040'>Was quel erra chs lusye eazas&nbsp;&nbsp;—<font size='1'>EXEC_VIENA/.</font></font></i>\n\n<b>&lt;DIALECT&gt;</b> Metafalss Note\n
lyafre	[ryafure]\n▪<i><font face='mono'>n.</font></i>\nbutterfly: <i><font color='#404040'>Wee yea ra rre lyafre famfa en jass anw iasien&nbsp;&nbsp;—<font size='1'>EXEC_over.METHOD_SUBLIMATION/.~omness chs ciel sos infel</font></font></i>\n\n<b>&lt;DIALECT&gt;</b> Cult Ciel Note\n
lyrnya	[?]\n▪<i><font face='mono'>adjective</font></i>\ngentle, peaceful \n\n<b>&lt;DIALECT&gt;</b> Unknown [Unofficial]\n
lyuma	[ryuma]\n▪<i><font face='mono'>n.</font></i>\nstar, planet (Note: if it has a "LYA" before it, the meaning changes to "Maiden of Mio"): <i><font color='#404040'>x. rre sarr m.n.g. du tyui lyuma&nbsp;&nbsp;—<font size='1'>EXEC_over.METHOD_SUBLIMATION/.~omness chs ciel sos infel</font></font></i>\n\n<b>&lt;DIALECT&gt;</b> New Testament of Pastalie\n
m.a.m.	[mamu]\n▪<i><font face='mono'>E.v.</font></i>\nexist\n\n<b>&lt;DIALECT&gt;</b> New Testament of Pastalie\n
m.f.l.	[?]\n▪<i><font face='mono'>E.v.</font></i>\ncover, shroud\n\n<b>&lt;DIALECT&gt;</b> Pastalie [Unofficial]\n
m.n.g.	[ngu]\n▪<i><font face='mono'>E.v.</font></i>\ndrink, understand, learn: <i><font color='#404040'>x. sorr m.n.g. dn z.z.x.&nbsp;&nbsp;—<font size='1'>METHOD_REPLEKIA/.</font></font></i>\n\n<b>&lt;DIALECT&gt;</b> New Testament of Pastalie\n
m.r.r.	[?]\n▪<i><font face='mono'>E.v.</font></i>\nreflect, project: <i><font color='#404040'>x. sorr m.r.r. du sphaela&nbsp;&nbsp;—<font size='1'>METHOD_REPLEKIA/.</font></font></i>\n\n<b>&lt;DIALECT&gt;</b> Pastalie [Unofficial]\n
m.t.y.y.	[matoui]\n▪<i><font face='mono'>E.v.</font></i>\ncreate, give birth to: <i><font color='#404040'>x. rre m.t.y.y. giz w.s. du giz&nbsp;&nbsp;—<font size='1'>METHOD_REPLEKIA/.</font></font></i>\n\n<b>&lt;DIALECT&gt;</b> New Testament of Pastalie\n
maen	[maen]\n▪<i><font face='mono'>n.</font></i>\nfull moon: <i><font color='#404040'>x. harr l.k.k. maen&nbsp;&nbsp;—<font size='1'>METHOD_REPLEKIA/.</font></font></i>\n\n<b>&lt;DIALECT&gt;</b> New Testament of Pastalie\n
mahin	[maain]\n▪<i><font face='mono'>n.</font></i>\nhand\n\n<b>&lt;DIALECT&gt;</b> Central Standard Note\n
manaf	[manafu]\n▪<i><font face='mono'>n.</font></i>\nlife, existence: <i><font color='#404040'>manaf O&nbsp;&nbsp;—<font size='1'>EXEC_PURGER/.#Aurica extracting</font></font></i>\n\n<b>&lt;DIALECT&gt;</b> Metafalss Note\n
manafaln	[manafarun]\n▪<i><font face='mono'>n.</font></i>\nreincarnation\n\n<b>&lt;DIALECT&gt;</b> Cult Ciel Note\n
manafeeze	[manafi^tsue]\n▪<i><font face='mono'>v.</font></i>\nlive\n\n<b>&lt;DIALECT&gt;</b> Metafalss Note\n
maoh	[mao]\n▪<i><font face='mono'>noun</font></i>\nMaoh, Rhaplanca's partner in Meta Falss mythology  \n\n<b>&lt;DIALECT&gt;</b> Metafalss Note\n
marfo	[?]\n▪<i><font face='mono'>adjective</font></i>\nbeloved, dear \n\n<b>&lt;DIALECT&gt;</b> Unknown [Unofficial]\n
marta	[maruta]\n▪<i><font face='mono'>n./adj.</font></i>\nmother, motherly: <i><font color='#404040'>Was i ra presia fogabe marta presia fogabe marta&nbsp;&nbsp;—<font size='1'>Eternally Bonded</font></font></i>\n\n<b>&lt;DIALECT&gt;</b> Metafalss Note\n
maun	[maun]\n▪<i><font face='mono'>n.</font></i>\neyelid: <i><font color='#404040'>en tarfe tou yos maun&nbsp;&nbsp;—<font size='1'>EXEC_over.METHOD_SUBLIMATION/.~omness chs ciel sos infel</font></font></i>\n\n<b>&lt;DIALECT&gt;</b> Cult Ciel Note\n
maxim	[makushimu]\n▪<i><font face='mono'>adj./adv.</font></i>\nmost, extremely: <i><font color='#404040'>den vinan fusya omnis dius en fusya maxim&nbsp;&nbsp;—<font size='1'>Colors~SEN~Will This Flower Bloom? 	</font></font></i>\n\n<b>&lt;DIALECT&gt;</b> Central Standard Note\n
maya	[maya]\n▪<i><font face='mono'>n.</font></i>\nmagic, supernatural: <i><font color='#404040'>Ma ki ga ks maya yor syec&nbsp;&nbsp;—<font size='1'>Singing Hill</font></font></i>\n\n<b>&lt;DIALECT&gt;</b> Cult Ciel Note\n
mea	[mi^a]\n▪<i><font face='mono'>n.</font></i>\nme (object): <i><font color='#404040'>Forgandal ar dius near grandus mea der dilete&nbsp;&nbsp;—<font size='1'>Singing Hill - Harmonics FRELIA </font></font></i>\n\n<b>&lt;DIALECT&gt;</b> Central Standard Note\n
mean	[mi^n]\n▪<i><font face='mono'>n.</font></i>\nus (object)\n\n<b>&lt;DIALECT&gt;</b> Central Standard Note\n
meaql	[?]\n▪<i><font face='mono'>adjective</font></i>\ngentle \n\n<b>&lt;DIALECT&gt;</b> Unknown [Unofficial]\n
melenas	[merenasu]\n▪<i><font face='mono'>v.</font></i>\nlove, very fond of (Note: Used to talk about the most irreplaceable person to the speaker): <i><font color='#404040'>en melenas oure en yanwe oure sor&nbsp;&nbsp;—<font size='1'>EXEC_over.METHOD_SUBLIMATION/.~omness chs ciel sos infel</font></font></i>\n\n<b>&lt;DIALECT&gt;</b> Cult Ciel Note\n
melifan	[merifan]\n▪<i><font face='mono'>n.</font></i>\nhistory: <i><font color='#404040'>fandel zadius hierle melifan iem endia&nbsp;&nbsp;—<font size='1'>EXEC_HARMONIOUS</font></font></i>\n\n<b>&lt;DIALECT&gt;</b> Metafalss Note\n
melvaz	[meruvazu]\n▪<i><font face='mono'>n.</font></i>\nbride\n\n<b>&lt;DIALECT&gt;</b> Cult Ciel Note\n
memora	[memo^ra]\n▪<i><font face='mono'>n.</font></i>\nmemory: <i><font color='#404040'>art crudea en raklya art idesy memora&nbsp;&nbsp;—<font size='1'>EXEC_over.METHOD_SUBLIMATION/.~omness chs ciel sos infel</font></font></i>\n\n<b>&lt;DIALECT&gt;</b> Central Standard Note\n
meo	[meo]\n▪<i><font face='mono'>n.</font></i>\nideal, dream\n\n<b>&lt;DIALECT&gt;</b> Central Standard Note\n
merfa	[?]\n▪<i><font face='mono'>adj./n.</font></i>\npure, pure wishes: <i><font color='#404040'>h.k.t.t merfa tie yor en h.m.m.r. METAFALICA&nbsp;&nbsp;—<font size='1'>METHOD_METAFALICA/.</font></font></i>\n\n<b>&lt;DIALECT&gt;</b> Pastalie [Unofficial]\n
merra	[?]\n▪<i><font face='mono'>n.</font></i>\nus (subject)\n\n<b>&lt;DIALECT&gt;</b> Central Standard Note\n
meryu	[meryu]\n▪<i><font face='mono'>n.</font></i>\nmemory (Note: if it's preceeded by an "A" emotion vowel, then its meaning is changed to "dream")\n\n<b>&lt;DIALECT&gt;</b> New Testament of Pastalie\n
meso	[meso]\n▪<i><font face='mono'>v.</font></i>\nscatter, leave untidy: <i><font color='#404040'>Rrha wol ra eta meso faura anw dornpica&nbsp;&nbsp;—<font size='1'>EXEC_HIBERNATION/.</font></font></i>\n\n<b>&lt;DIALECT&gt;</b> Central Standard Note\n
messe	[messe^]\n▪<i><font face='mono'>v.</font></i>\nreport, transmit, convey: <i><font color='#404040'>Ma ki ra murfanare messe murfanare messe&nbsp;&nbsp;—<font size='1'>Eternally Bonded</font></font></i>\n\n<b>&lt;DIALECT&gt;</b> Central Standard Note\n
milra	[?]\n▪<i><font face='mono'>noun</font></i>\nfragrance \n\n<b>&lt;DIALECT&gt;</b> Unknown [Unofficial]\n
mirie	[?]\n▪<i><font face='mono'>n.</font></i>\nwarmth: <i><font color='#404040'>x. rre s.n.k.k. mirie ag h.m.m.r. eje&nbsp;&nbsp;—<font size='1'>METHOD_REPLEKIA/.</font></font></i>\n\n<b>&lt;DIALECT&gt;</b> Pastalie [Unofficial]\n
morto	[moruto]\n▪<i><font face='mono'>n./v.</font></i>\ndeath, die: <i><font color='#404040'>Rrha num ra slepir etealune na near na morto ciel&nbsp;&nbsp;—<font size='1'>EXEC_HIBERNATION/.</font></font></i>\n\n<b>&lt;DIALECT&gt;</b> Central Standard Note\n
murfan	[murufan]\n▪<i><font face='mono'>v.</font></i>\nfeel, think: <i><font color='#404040'>Faura yerwe murfan anw sol ciel&nbsp;&nbsp;—<font size='1'>EXEC_HARMONIOUS_FUSION/.</font></font></i>\n\n<b>&lt;DIALECT&gt;</b> Metafalss Note\n
murfanare	[murufana^re]\n▪<i><font face='mono'>n.</font></i>\nfeeling, thought: <i><font color='#404040'>Ma ki ra murfanare messe murfanare messe&nbsp;&nbsp;—<font size='1'>Eternally Bonded</font></font></i>\n\n<b>&lt;DIALECT&gt;</b> Metafalss Note\n
mutrk	[?]\n▪<i><font face='mono'>n.</font></i>\nwarmth: <i><font color='#404040'>x. sorr a.u.k. mutrk rhaplanca en Implanta&nbsp;&nbsp;—<font size='1'>METHOD_METAFALICA/.</font></font></i>\n\n<b>&lt;DIALECT&gt;</b> Pastalie [Unofficial]\n
n.d.n.	[?]\n▪<i><font face='mono'>E.v.</font></i>\nlay, put down, hide\n\n<b>&lt;DIALECT&gt;</b> Pastalie [Unofficial]\n
n.e.g.	[?]\n▪<i><font face='mono'>Emotion Verb</font></i>\npray \n\n<b>&lt;DIALECT&gt;</b> Pastalie [Unofficial]\n
n.m.l.	[nmu]\n▪<i><font face='mono'>E.v.</font></i>\ndye, color: <i><font color='#404040'>x. rre y.z.t. aje tafane n.m.l. sphaela&nbsp;&nbsp;—<font size='1'>METHOD_REPLEKIA/.</font></font></i>\n\n<b>&lt;DIALECT&gt;</b> New Testament of Pastalie\n
n.t.n.	[?]\n▪<i><font face='mono'>E.v.</font></i>\ncontinue, go on: <i><font color='#404040'>x. harr n.t.n. hymmnos&nbsp;&nbsp;—<font size='1'>METHOD_REPLEKIA/.</font></font></i>\n\n<b>&lt;DIALECT&gt;</b> Pastalie [Unofficial]\n
na	[na]\n▪<i><font face='mono'>adv.</font></i>\nno, not, negation: <i><font color='#404040'>Hymmnos oz faura pomb na omnis den accrroad&nbsp;&nbsp;—<font size='1'>EXEC_HARMONIOUS_FUSION/.</font></font></i>\n\n<b>&lt;DIALECT&gt;</b> Central Standard Note\n
naave	[naabe]\n▪<i><font face='mono'>conj.</font></i>\nbecause ~\n\n<b>&lt;DIALECT&gt;</b> New Testament of Pastalie\n
nafa	[nafa]\n▪<i><font face='mono'>adj.</font></i>\neasy, gentle: <i><font color='#404040'>v.s.k. sarr arhou nafa infel&nbsp;&nbsp;—<font size='1'>EXEC_with.METHOD_METAFALICA/.</font></font></i>\n\n<b>&lt;DIALECT&gt;</b> New Testament of Pastalie\n
nafan	[nafan]\n▪<i><font face='mono'>adj.</font></i>\nkind, tender: <i><font color='#404040'>x. rre h.k.t.t nafan ouwua siann arhou&nbsp;&nbsp;—<font size='1'>METHOD_REPLEKIA/.</font></font></i>\n\n<b>&lt;DIALECT&gt;</b> New Testament of Pastalie\n
naflansee	[nafuranzui^]\n▪<i><font face='mono'>n.</font></i>\nhappiness, good fortune\n\n<b>&lt;DIALECT&gt;</b> New Testament of Pastalie\n
naja	[na^ja]\n▪<i><font face='mono'>v.</font></i>\nescape, retreat, disappear, leave: <i><font color='#404040'>Rrha wol ra stel naja getrra faura anw dornpica&nbsp;&nbsp;—<font size='1'>EXEC_HIBERNATION/.</font></font></i>\n\n<b>&lt;DIALECT&gt;</b> Cult Ciel Note\n
near	[niea^]\n▪<i><font face='mono'>n.</font></i>\nlife: <i><font color='#404040'>Forgandal ar dius near grandus mea der dilete&nbsp;&nbsp;—<font size='1'>Singing Hill - Harmonics FRELIA </font></font></i>\n\n<b>&lt;DIALECT&gt;</b> Central Standard Note\n
neath	[?]\n▪<i><font face='mono'>adjective</font></i>\nred hot, scorching \n\n<b>&lt;DIALECT&gt;</b> Unknown [Unofficial]\n
nedle	[nidouru]\n▪<i><font face='mono'>v.</font></i>\nneed: <i><font color='#404040'>Was au ga whai pauwel ferda enter whou na nedle sor&nbsp;&nbsp;—<font size='1'>EXEC_CHRONICLE KEY</font></font></i>\n\n<b>&lt;DIALECT&gt;</b> Alpha Note (EOLIA)\n
neee	[nee]\n▪<i><font face='mono'>v.</font></i>\ncall out\n\n<b>&lt;DIALECT&gt;</b> Central Standard Note\n
neen	[ni^n]\n▪<i><font face='mono'>adjective, adverb</font></i>\ntoo much, excessive, beyond reason \n\n<b>&lt;DIALECT&gt;</b> Cult Ciel Note\n
neia	[neia]\n▪<i><font face='mono'>v.</font></i>\napproach, draw near: <i><font color='#404040'>Was paks ra neia bautifal faura tes dornpica&nbsp;&nbsp;—<font size='1'>EXEC_HIBERNATION/.</font></font></i>\n\n<b>&lt;DIALECT&gt;</b> Central Standard Note\n
nene	[nene]\n▪<i><font face='mono'>adj.</font></i>\nnot understand\n\n<b>&lt;DIALECT&gt;</b> Cult Ciel Note\n
nepo	[nepo]\n▪<i><font face='mono'>v.</font></i>\nmoisten: <i><font color='#404040'>Fou yea ra waath ar ciel en hymme mea weel nepo en keen ar sar&nbsp;&nbsp;—<font size='1'>EXEC_PHANTASMAGORIA/.</font></font></i>\n\n<b>&lt;DIALECT&gt;</b> Central Standard Note\n
netvear	[netovia]\n▪<i><font face='mono'>v.</font></i>\ngive up, abandon, be discouraged\n\n<b>&lt;DIALECT&gt;</b> Central Standard Note\n
nezz	[nezu]\n▪<i><font face='mono'>n.</font></i>\nnose\n\n<b>&lt;DIALECT&gt;</b> Central Standard Note\n
nha	[nya]\n▪<i><font face='mono'>v.</font></i>\nlet in, summon (Note: It isn't used to refer to a physical phenomenon, rather, it's for situations were magic is being used): <i><font color='#404040'>Rrha ki ra tie yor ini en nha&nbsp;&nbsp;—<font size='1'>Singing Hill</font></font></i>\n\n<b>&lt;DIALECT&gt;</b> Cult Ciel Note\n
nhaf	[?]\n▪<i><font face='mono'>adj.</font></i>\nsurprised, dazed: <i><font color='#404040'>Harr ar vit plina has nhaf&nbsp;&nbsp;—<font size='1'>EXEC_METAFALICA/.</font></font></i>\n\n<b>&lt;DIALECT&gt;</b> Unknown [Unofficial]\n
nille	[niru]\n▪<i><font face='mono'>v.</font></i>\nresemble, resemblance, be alike: <i><font color='#404040'>Yorr nille mea&nbsp;&nbsp;—<font size='1'>EXEC_SPHILIA/.</font></font></i>\n\n<b>&lt;DIALECT&gt;</b> Central Standard Note\n
nnoini	[noini]\n▪<i><font face='mono'>adv.</font></i>\nfirst (Note: Combination of "Nnoi" (1) and "Ini" (Initialize)): <i><font color='#404040'>clalliss vit iem nnoini&nbsp;&nbsp;—<font size='1'>EXEC_HARMONIOUS_FUSION/.</font></font></i>\n\n<b>&lt;DIALECT&gt;</b> Central Standard Note\n
noce	[no^se]\n▪<i><font face='mono'>n.</font></i>\nnatural, spontaneous: <i><font color='#404040'>Presia messe noce yor tes mea&nbsp;&nbsp;—<font size='1'>EXEC_SPHILIA/.</font></font></i>\n\n<b>&lt;DIALECT&gt;</b> Cult Ciel Note\n
noes	[noisu]\n▪<i><font face='mono'>n.</font></i>\noneself: <i><font color='#404040'>Rrha ki ra sarrifis mea noes tes inferiare saash&nbsp;&nbsp;—<font size='1'>EXEC_SOL=FAGE/.</font></font></i>\n\n<b>&lt;DIALECT&gt;</b> Central Standard Note\n
noglle	[noguru]\n▪<i><font face='mono'>adj./n.</font></i>\nblack: <i><font color='#404040'>x. rre omness a.u.k. zodaw ess rudje noglle doodu&nbsp;&nbsp;—<font size='1'>EXEC_over.METHOD_SUBLIMATION/.~lamenza</font></font></i>\n\n<b>&lt;DIALECT&gt;</b> Central Standard Note\n
nooge	[nu^gu]\n▪<i><font face='mono'>v.</font></i>\nsleep\n\n<b>&lt;DIALECT&gt;</b> Cult Ciel Note\n
nor	[?]\n▪<i><font face='mono'>pre.</font></i>\nor, either: <i><font color='#404040'>infel nor khule hopb&nbsp;&nbsp;—<font size='1'>The Heart Speaks</font></font></i>\n\n<b>&lt;DIALECT&gt;</b> Unknown [Unofficial]\n
nosaash	[no^sasshu]\n▪<i><font face='mono'>n.</font></i>\ngoddess\n\n<b>&lt;DIALECT&gt;</b> Cult Ciel Note\n
nozess	[no^zesu]\n▪<i><font face='mono'>v.</font></i>\nlose, get rid of, waste: <i><font color='#404040'>wassee forgandal dauane keenis na nozess&nbsp;&nbsp;—<font size='1'>EXEC_over.METHOD_SUBLIMATION/.~omness chs ciel sos infel</font></font></i>\n\n<b>&lt;DIALECT&gt;</b> Central Standard Note\n
nuih	[nui]\n▪<i><font face='mono'>n.</font></i>\nnight: <i><font color='#404040'>En 1 dyyal nuih bexm&nbsp;&nbsp;—<font size='1'>EXEC_HIBERNATION/.</font></font></i>\n\n<b>&lt;DIALECT&gt;</b> Central Standard Note\n
num	[namu]\n▪<i><font face='mono'>E.s. II</font></i>\nnothing: <i><font color='#404040'>Ma num ra flip 0x1011001001 yor&nbsp;&nbsp;—<font size='1'>Singing Hill</font></font></i>\n\n<b>&lt;DIALECT&gt;</b> Central Standard Note\n
nx	[nukusu]\n▪<i><font face='mono'>n.</font></i>\nnext\n\n<b>&lt;DIALECT&gt;</b> Central Standard Note\n
nyamo	[?]\n▪<i><font face='mono'>noun, verb</font></i>\nmeowing \n\n<b>&lt;DIALECT&gt;</b> Unknown [Unofficial]\n
nyamonyas	[?]\n▪<i><font face='mono'>noun</font></i>\nfriend \n\n<b>&lt;DIALECT&gt;</b> Unknown [Unofficial]\n
nyanyas	[?]\n▪<i><font face='mono'>adj.</font></i>\ncute, lovely, darling\n\n<b>&lt;DIALECT&gt;</b> Unknown [Unofficial]\n
nyasri	[nyasuri]\n▪<i><font face='mono'>E.s. II</font></i>\nsad: <i><font color='#404040'>Was nyasri ga hieg yorra guaysu&nbsp;&nbsp;—<font size='1'>EXEC_over.METHOD_SUBLIMATION/.~omness chs ciel sos infel</font></font></i>\n\n<b>&lt;DIALECT&gt;</b> Cult Ciel Note\n
nyasyamorina	[?]\n▪<i><font face='mono'>adjective</font></i>\nvery happy \n\n<b>&lt;DIALECT&gt;</b> Unknown [Unofficial]\n
ocurp	[?]\n▪<i><font face='mono'>noun</font></i>\nriver mouth \n\n<b>&lt;DIALECT&gt;</b> Unknown [Unofficial]\n
ogbl	[?]\n▪<i><font face='mono'>verb</font></i>\ncoil into \n\n<b>&lt;DIALECT&gt;</b> Unknown [Unofficial]\n
olo	[oro]\n▪<i><font face='mono'>n.</font></i>\nnight\n\n<b>&lt;DIALECT&gt;</b> New Testament of Pastalie\n
omness	[?]\n▪<i><font face='mono'>n.</font></i>\nlife, existence: <i><font color='#404040'>x. rre omness a.u.k. zodaw ess rudje noglle doodu&nbsp;&nbsp;—<font size='1'>EXEC_over.METHOD_SUBLIMATION/.~lamenza</font></font></i>\n\n<b>&lt;DIALECT&gt;</b> Unknown [Unofficial]\n
omnis	[omunisu]\n▪<i><font face='mono'>adj.</font></i>\neverything (direct object): <i><font color='#404040'>Hymmnos oz faura pomb na omnis den accrroad&nbsp;&nbsp;—<font size='1'>EXEC_HARMONIOUS_FUSION/.</font></font></i>\n\n<b>&lt;DIALECT&gt;</b> Metafalss Note\n
oriye	[oriie]\n▪<i><font face='mono'>n.</font></i>\near\n\n<b>&lt;DIALECT&gt;</b> Central Standard Note\n
orn	[?]\n▪<i><font face='mono'>adjective</font></i>\nonly, sole, unique \n\n<b>&lt;DIALECT&gt;</b> Unknown [Unofficial]\n
orviclle	[o^vikuru]\n▪<i><font face='mono'>n.</font></i>\nproblem, question, obstacle (Note: na orviclle can mean "no problem" or "it's okay").: <i><font color='#404040'>Den na orviclle vis ween leaff&nbsp;&nbsp;—<font size='1'>EXEC_HARMONIOUS_FUSION/.</font></font></i>\n\n<b>&lt;DIALECT&gt;</b> Central Standard Note\n
oter	[?]\n▪<i><font face='mono'>pre.</font></i>\nout from ~ (note: only used in Hymmnos Spells)\n\n<b>&lt;DIALECT&gt;</b> Unknown [Unofficial]\n
oucc	[ouku]\n▪<i><font face='mono'>adv.</font></i>\ntogether\n\n<b>&lt;DIALECT&gt;</b> New Testament of Pastalie\n
oure	[oure]\n▪<i><font face='mono'>pre.</font></i>\nmore than anything: <i><font color='#404040'>en melenas oure en yanwe oure sor&nbsp;&nbsp;—<font size='1'>EXEC_over.METHOD_SUBLIMATION/.~omness chs ciel sos infel</font></font></i>\n\n<b>&lt;DIALECT&gt;</b> Central Standard Note\n
ousye	[oushie]\n▪<i><font face='mono'>v.</font></i>\nlaunch an attack, fall onto: <i><font color='#404040'>fatere tes pauwel chs deleir en ousye yor&nbsp;&nbsp;—<font size='1'>EXEC_CHRONICLE KEY</font></font></i>\n\n<b>&lt;DIALECT&gt;</b> Alpha Note (EOLIA)\n
ouvyu	[ouvuyu]\n▪<i><font face='mono'>n.</font></i>\nruins: <i><font color='#404040'>vega ouvyu giz sphaela&nbsp;&nbsp;—<font size='1'>METHOD_REPLEKIA/.</font></font></i>\n\n<b>&lt;DIALECT&gt;</b> New Testament of Pastalie\n
ouwua	[ouea]\n▪<i><font face='mono'>adj.</font></i>\na lot, many, much: <i><font color='#404040'>x. harr j.z.t. ouwua giz hymmnos&nbsp;&nbsp;—<font size='1'>METHOD_REPLEKIA/.</font></font></i>\n\n<b>&lt;DIALECT&gt;</b> New Testament of Pastalie\n
oz	[ozu]\n▪<i><font face='mono'>pre.</font></i>\nof (possessive article) (Note: Equivalent to the English "of", though depending on context, it isn't always necessary): <i><font color='#404040'>Hymmnos oz faura pomb na omnis den accrroad&nbsp;&nbsp;—<font size='1'>EXEC_HARMONIOUS_FUSION/.</font></font></i>\n\n<b>&lt;DIALECT&gt;</b> Central Standard Note\n
p.s.w.t.	[pisuuto]\n▪<i><font face='mono'>E.v.</font></i>\nseize, adquire\n\n<b>&lt;DIALECT&gt;</b> New Testament of Pastalie\n
pagle	[pagure]\n▪<i><font face='mono'>v.</font></i>\ntalk, speak with: <i><font color='#404040'>Kiafa hynne mea pagle tes yor&nbsp;&nbsp;—<font size='1'>EXEC_SPHILIA/.</font></font></i>\n\n<b>&lt;DIALECT&gt;</b> Central Standard Note\n
pak	[paku]\n▪<i><font face='mono'>v.</font></i>\nopen (the future): <i><font color='#404040'>Was yea ra wael yor pak en ini pat yor&nbsp;&nbsp;—<font size='1'>Chanting the Moon ~Tsukikanade~</font></font></i>\n\n<b>&lt;DIALECT&gt;</b> Central Standard Note\n
paks	[pakusu]\n▪<i><font face='mono'>E.s. II</font></i>\nexcitement, nervouseness: <i><font color='#404040'>Was paks ra neia bautifal faura tes dornpica&nbsp;&nbsp;—<font size='1'>EXEC_HIBERNATION/.</font></font></i>\n\n<b>&lt;DIALECT&gt;</b> Central Standard Note\n
pakz	[pakuzu]\n▪<i><font face='mono'>v.</font></i>\ndivide, separate\n\n<b>&lt;DIALECT&gt;</b> Cult Ciel Note\n
papana	[papana]\n▪<i><font face='mono'>n.</font></i>\nrain: <i><font color='#404040'>x. rre vonn papana f.p.n. ut kvyeire qoga iem&nbsp;&nbsp;—<font size='1'>EXEC_over.METHOD_SUBLIMATION/.~lamenza</font></font></i>\n\n<b>&lt;DIALECT&gt;</b> Cult Ciel Note\n
papas	[?]\n▪<i><font face='mono'>n.</font></i>\nbelief\n\n<b>&lt;DIALECT&gt;</b> Unknown [Unofficial]\n
papulipua	[?]\n▪<i><font face='mono'>verb</font></i>\nworry, bother \n\n<b>&lt;DIALECT&gt;</b> Unknown [Unofficial]\n
parce	[pa^shie]\n▪<i><font face='mono'>n.</font></i>\nevidence, proof\n\n<b>&lt;DIALECT&gt;</b> Central Standard Note\n
parge	[pajie]\n▪<i><font face='mono'>v.</font></i>\nto cut loose (in the case of magic) (Note: It isn't used to refer to a physical phenomenon, rather, it's for situations were magic is being used): <i><font color='#404040'>Wee ki ra parge yor ar ciel&nbsp;&nbsp;—<font size='1'>Singing Hill</font></font></i>\n\n<b>&lt;DIALECT&gt;</b> Cult Ciel Note\n
parith	[parisu]\n▪<i><font face='mono'>adj./n.</font></i>\nhonest, sincere\n\n<b>&lt;DIALECT&gt;</b> Cult Ciel Note\n
pat	[patsu]\n▪<i><font face='mono'>v.</font></i>\nrelease, set free: <i><font color='#404040'>Rrha ki ra nha-HYMMNOS1x01 >> pat mea en xest SOL=MARTA > A2&nbsp;&nbsp;—<font size='1'>EXEC_SOL=FAGE/.</font></font></i>\n\n<b>&lt;DIALECT&gt;</b> Cult Ciel Note\n
paul	[pauru]\n▪<i><font face='mono'>v.</font></i>\nfeel, sense: <i><font color='#404040'>walasye near enesse mea paul li ciel&nbsp;&nbsp;—<font size='1'>Colors~SEN~Will This Flower Bloom? 	</font></font></i>\n\n<b>&lt;DIALECT&gt;</b> Cult Ciel Note\n
pauwee	[pauue^]\n▪<i><font face='mono'>n.</font></i>\nchild of power\n\n<b>&lt;DIALECT&gt;</b> Metafalss Note\n
pauwel	[pauueru]\n▪<i><font face='mono'>n.</font></i>\npower: <i><font color='#404040'>Was au ga whai pauwel ferda enter whou na nedle sor&nbsp;&nbsp;—<font size='1'>EXEC_CHRONICLE KEY</font></font></i>\n\n<b>&lt;DIALECT&gt;</b> Metafalss Note\n
pawr	[?]\n▪<i><font face='mono'>noun</font></i>\npower, strength \n\n<b>&lt;DIALECT&gt;</b> Unknown [Unofficial]\n
pecee	[pishi]\n▪<i><font face='mono'>v.</font></i>\nhatch (egg), incubate\n\n<b>&lt;DIALECT&gt;</b> Central Standard Note\n
phira	[pira]\n▪<i><font face='mono'>n.</font></i>\nseed, kind: <i><font color='#404040'>Rhaplanca selena phira&nbsp;&nbsp;—<font size='1'>EXEC_METAFALICA/.</font></font></i>\n\n<b>&lt;DIALECT&gt;</b> Metafalss Note\n
phiz	[fizu]\n▪<i><font face='mono'>noun</font></i>\nbody \n\n<b>&lt;DIALECT&gt;</b> Cult Ciel Note\n
phyue	[hyuu]\n▪<i><font face='mono'>n.</font></i>\ncongratulations\n\n<b>&lt;DIALECT&gt;</b> Central Standard Note\n
pic	[piku]\n▪<i><font face='mono'>v.</font></i>\nrealize, take aback\n\n<b>&lt;DIALECT&gt;</b> Central Standard Note\n
pikca	[pikka]\n▪<i><font face='mono'>n.</font></i>\nfruit, nut\n\n<b>&lt;DIALECT&gt;</b> New Testament of Pastalie\n
pilt	[piruto]\n▪<i><font face='mono'>v.</font></i>\nrealize\n\n<b>&lt;DIALECT&gt;</b> Cult Ciel Note\n
pipel	[piperu]\n▪<i><font face='mono'>adj./n.</font></i>\npipe, cylindrical\n\n<b>&lt;DIALECT&gt;</b> Central Standard Note\n
pipit	[pipitto]\n▪<i><font face='mono'>adj.</font></i>\nonly, merely, a little\n\n<b>&lt;DIALECT&gt;</b> New Testament of Pastalie\n
pirtue	[pirichue]\n▪<i><font face='mono'>n.</font></i>\nspirit, ghost\n\n<b>&lt;DIALECT&gt;</b> Metafalss Note\n
pitod	[pitoddo]\n▪<i><font face='mono'>adv.</font></i>\nbeside, together: <i><font color='#404040'>Was yea ra chs yuez en yanje yanje pitod yor&nbsp;&nbsp;—<font size='1'>EXEC_over.METHOD_SUBLIMATION/.~omness chs ciel sos infel</font></font></i>\n\n<b>&lt;DIALECT&gt;</b> Cult Ciel Note\n
plina	[purina]\n▪<i><font face='mono'>n.</font></i>\ngreenery (plants) (Note: Used only for talking about green plants): <i><font color='#404040'>chs plina en grlanza art fhyu&nbsp;&nbsp;—<font size='1'>EXEC_over.METHOD_SUBLIMATION/.~omness chs ciel sos infel</font></font></i>\n\n<b>&lt;DIALECT&gt;</b> Central Standard Note\n
poe	[poe]\n▪<i><font face='mono'>n.</font></i>\nseed, kind: <i><font color='#404040'>x. rre rhaplanca t.n.m.n. poe ess gkgul doodu&nbsp;&nbsp;—<font size='1'>METHOD_METAFALICA/.</font></font></i>\n\n<b>&lt;DIALECT&gt;</b> New Testament of Pastalie\n
polon	[poron]\n▪<i><font face='mono'>n.</font></i>\nloneliness, solitude: <i><font color='#404040'>van yor jyel der polon&nbsp;&nbsp;—<font size='1'>EXEC_VIENA/.</font></font></i>\n\n<b>&lt;DIALECT&gt;</b> Cult Ciel Note\n
pomb	[pomu]\n▪<i><font face='mono'>v.</font></i>\ngive birth, create: <i><font color='#404040'>pomb yor en yor&nbsp;&nbsp;—<font size='1'>Singing Hill</font></font></i>\n\n<b>&lt;DIALECT&gt;</b> Central Standard Note\n
pono	[pono]\n▪<i><font face='mono'>n.</font></i>\negg\n\n<b>&lt;DIALECT&gt;</b> Central Standard Note\n
pop	[popu]\n▪<i><font face='mono'>n.</font></i>\nbubble\n\n<b>&lt;DIALECT&gt;</b> New Testament of Pastalie\n
porter	[porutea]\n▪<i><font face='mono'>v.</font></i>\nwear (clothes)\n\n<b>&lt;DIALECT&gt;</b> Central Standard Note\n
prasrity	[purasuritei^]\n▪<i><font face='mono'>n./v.</font></i>\nprosperity, prosper: <i><font color='#404040'>Was yea ra prasrity&nbsp;&nbsp;—<font size='1'>EXEC_HIBERNATION/.</font></font></i>\n\n<b>&lt;DIALECT&gt;</b> Central Standard Note\n
presia	[pureshia]\n▪<i><font face='mono'>adv.</font></i>\nmay it be so, would you please do ~, please ~: <i><font color='#404040'>Was i ra presia fogabe marta presia fogabe marta&nbsp;&nbsp;—<font size='1'>Eternally Bonded</font></font></i>\n\n<b>&lt;DIALECT&gt;</b> Metafalss Note\n
prooth	[puru^su]\n▪<i><font face='mono'>n.</font></i>\nblood\n\n<b>&lt;DIALECT&gt;</b> Cult Ciel Note\n
pruna	[?]\n▪<i><font face='mono'>adj.</font></i>\nfunny\n\n<b>&lt;DIALECT&gt;</b> Unknown [Unofficial]\n
ptrapica	[putorapika]\n▪<i><font face='mono'>n.</font></i>\ntreasure\n\n<b>&lt;DIALECT&gt;</b> Cult Ciel Note\n
ptrapile	[putorapiru]\n▪<i><font face='mono'>n.</font></i>\nautumn\n\n<b>&lt;DIALECT&gt;</b> Cult Ciel Note\n
pupe	[pyu^pe]\n▪<i><font face='mono'>n.</font></i>\ntear, teardrop\n\n<b>&lt;DIALECT&gt;</b> New Testament of Pastalie\n
pyuf	[?]\n▪<i><font face='mono'>verb</font></i>\nhead for, head to \n\n<b>&lt;DIALECT&gt;</b> Unknown [Unofficial]\n
q.g.s.	[?]\n▪<i><font face='mono'>E.v.</font></i>\nend, finish\n\n<b>&lt;DIALECT&gt;</b> Pastalie [Unofficial]\n
q.l.s.	[?]\n▪<i><font face='mono'>E.v.</font></i>\nshake tremendously: <i><font color='#404040'>x. rre h.m.m.r. byui q.l.s. du sechel&nbsp;&nbsp;—<font size='1'>METHOD_REPLEKIA/.</font></font></i>\n\n<b>&lt;DIALECT&gt;</b> Pastalie [Unofficial]\n
qejyu	[kejieu]\n▪<i><font face='mono'>n.</font></i>\npeople, humanity (Notes: Preceeded by an "E" emotion vowel, the meaning changes to "lover" and "wife/husband". Preceeded by an "YE" emotion vowel, the meaning changes to "family, relatives, friends". Preceeded by an "LYE" emotion vowel, the meaning changes to "the grand family of humankind".): <i><font color='#404040'>x. harr k.v.r. du qejyu&nbsp;&nbsp;—<font size='1'>METHOD_REPLEKIA/.</font></font></i>\n\n<b>&lt;DIALECT&gt;</b> New Testament of Pastalie\n
qoga	[?]\n▪<i><font face='mono'>n.</font></i>\nend, ending: <i><font color='#404040'>x. rre vonn papana f.p.n. ut kvyeire qoga iem&nbsp;&nbsp;—<font size='1'>EXEC_over.METHOD_SUBLIMATION/.~lamenza</font></font></i>\n\n<b>&lt;DIALECT&gt;</b> Unknown [Unofficial]\n
qraffa	[kuraffa]\n▪<i><font face='mono'>n.</font></i>\nleaf: <i><font color='#404040'>x. rre sefanl s.n.k.k. aje qraffa&nbsp;&nbsp;—<font size='1'>EXEC_over.METHOD_SUBLIMATION/.~omness chs ciel sos infel</font></font></i>\n\n<b>&lt;DIALECT&gt;</b> New Testament of Pastalie\n
quals	[?]\n▪<i><font face='mono'>verb</font></i>\nrevive, resurrect \n\n<b>&lt;DIALECT&gt;</b> Unknown [Unofficial]\n
quel	[kueru]\n▪<i><font face='mono'>E.s. II</font></i>\nearnestness, desperation: <i><font color='#404040'>Was quel erra chs lusye eazas&nbsp;&nbsp;—<font size='1'>EXEC_VIENA/.</font></font></i>\n\n<b>&lt;DIALECT&gt;</b> Central Standard Note\n
quen	[ku^n]\n▪<i><font face='mono'>v.</font></i>\ngive birth, create: <i><font color='#404040'>en sorr quen art ftt omnis crudea&nbsp;&nbsp;—<font size='1'>EXEC_over.METHOD_SUBLIMATION/.~omness chs ciel sos infel</font></font></i>\n\n<b>&lt;DIALECT&gt;</b> Central Standard Note\n
quesa	[kue^sa^]\n▪<i><font face='mono'>n.</font></i>\nthing that shakes the earth, thunder, lightning: <i><font color='#404040'>x. rre h.m.m.r. a.u.k. zess quesa&nbsp;&nbsp;—<font size='1'>METHOD_REPLEKIA/.</font></font></i>\n\n<b>&lt;DIALECT&gt;</b> Central Standard Note\n
quivale	[kuiba^re]\n▪<i><font face='mono'>n.</font></i>\nwinter\n\n<b>&lt;DIALECT&gt;</b> Cult Ciel Note\n
quive	[kuuiba]\n▪<i><font face='mono'>n/v.</font></i>\nsilence, quietness: <i><font color='#404040'>ciel ar celle weak ar quive&nbsp;&nbsp;—<font size='1'>Colors~SEN~Will This Flower Bloom? 	</font></font></i>\n\n<b>&lt;DIALECT&gt;</b> Cult Ciel Note\n
quowjaz	[kuoujazu]\n▪<i><font face='mono'>n.</font></i>\njustice, righteousness\n\n<b>&lt;DIALECT&gt;</b> Cult Ciel Note\n
r.f.m.	[rufun]\n▪<i><font face='mono'>E.v.</font></i>\nsee, watch\n\n<b>&lt;DIALECT&gt;</b> New Testament of Pastalie\n
r.f.r.m.	[rufurun]\n▪<i><font face='mono'>E.v.</font></i>\nknow, recognize\n\n<b>&lt;DIALECT&gt;</b> New Testament of Pastalie\n
r.l.t.y.	[?]\n▪<i><font face='mono'>E.v.</font></i>\nrevive, resurrect, rebirth: <i><font color='#404040'>x. rre mao y.z.t. en y.z.t. za rre arhou r.l.t.y. ess qejyu&nbsp;&nbsp;—<font size='1'>METHOD_METAFALICA/.</font></font></i>\n\n<b>&lt;DIALECT&gt;</b> Pastalie [Unofficial]\n
r.w.	[ruu]\n▪<i><font face='mono'>E.v.</font></i>\nhelp, rescue\n\n<b>&lt;DIALECT&gt;</b> New Testament of Pastalie\n
ra	[ra]\n▪<i><font face='mono'>E.s. III</font></i>\nI want this to last: <i><font color='#404040'>Wee ki ra ene rre sor hymme ar ciel en rre hymmnos ee powel&nbsp;&nbsp;—<font size='1'>Singing Hill - Harmonics FRELIA </font></font></i>\n\n<b>&lt;DIALECT&gt;</b> Central Standard Note\n
race	[re^su]\n▪<i><font face='mono'>n./v.</font></i>\n(wreathe a) necklace, to wreath\n\n<b>&lt;DIALECT&gt;</b> Central Standard Note\n
raklya	[rakurya]\n▪<i><font face='mono'>v.</font></i>\ncry, weep: <i><font color='#404040'>art crudea en raklya art idesy memora&nbsp;&nbsp;—<font size='1'>EXEC_over.METHOD_SUBLIMATION/.~omness chs ciel sos infel</font></font></i>\n\n<b>&lt;DIALECT&gt;</b> Cult Ciel Note\n
rana	[ra^na]\n▪<i><font face='mono'>v.</font></i>\nrun, dash: <i><font color='#404040'>chs bister en rana anw dor&nbsp;&nbsp;—<font size='1'>EXEC_over.METHOD_SUBLIMATION/.~omness chs ciel sos infel</font></font></i>\n\n<b>&lt;DIALECT&gt;</b> Central Standard Note\n
rannef	[raniefu]\n▪<i><font face='mono'>n.</font></i>\nreward\n\n<b>&lt;DIALECT&gt;</b> Central Standard Note\n
rasse	[rasse^]\n▪<i><font face='mono'>v.</font></i>\nto yell: <i><font color='#404040'>rasse&nbsp;&nbsp;—<font size='1'>EXEC_VIENA/.</font></font></i>\n\n<b>&lt;DIALECT&gt;</b> Central Standard Note\n
raudl	[raudouru]\n▪<i><font face='mono'>n.</font></i>\nform, shape\n\n<b>&lt;DIALECT&gt;</b> New Testament of Pastalie\n
rawah	[rawa]\n▪<i><font face='mono'>n.</font></i>\nflower\n\n<b>&lt;DIALECT&gt;</b> New Testament of Pastalie\n
re	[re]\n▪<i><font face='mono'>pre</font></i>\n(passive verb prefix): <i><font color='#404040'>Vinan wis pitod re beja&nbsp;&nbsp;—<font size='1'>Colors~SEN~Will This Flower Bloom? 	</font></font></i>\n\n<b>&lt;DIALECT&gt;</b> Central Standard Note\n
reen	[ri^n]\n▪<i><font face='mono'>v.</font></i>\nhear, listen: <i><font color='#404040'>Wee yea ra reen harton yos warma hynne reen yos warma hynne&nbsp;&nbsp;—<font size='1'>Eternally Bonded</font></font></i>\n\n<b>&lt;DIALECT&gt;</b> Central Standard Note\n
repoear	[repoea]\n▪<i><font face='mono'>n.</font></i>\nthanks, gratitude\n\n<b>&lt;DIALECT&gt;</b> Central Standard Note\n
reta	[reta]\n▪<i><font face='mono'>pre.</font></i>\nPlease...\n\n<b>&lt;DIALECT&gt;</b> New Testament of Pastalie\n
rete	[rete]\n▪<i><font face='mono'>n./v.</font></i>\nforget, forgetfulness, oblivion: <i><font color='#404040'>yorr rete yasra fhyu&nbsp;&nbsp;—<font size='1'>EXEC_SPHILIA/.</font></font></i>\n\n<b>&lt;DIALECT&gt;</b> Cult Ciel Note\n
revatail	[re^vateiru]\n▪<i><font face='mono'>n.</font></i>\nReyvateil (an artificial life form): <i><font color='#404040'>Was ki ra revatail whou Metafalica crushue Mule&nbsp;&nbsp;—<font size='1'>EXEC_HARMONIOUS</font></font></i>\n\n<b>&lt;DIALECT&gt;</b> Metafalss Note\n
reveris	[reberisu]\n▪<i><font face='mono'>n.</font></i>\ndream demon, nightmare, delusion: <i><font color='#404040'>Wee i ga vit anw reveris enrer&nbsp;&nbsp;—<font size='1'>EXEC_VIENA/.</font></font></i>\n\n<b>&lt;DIALECT&gt;</b> Central Standard Note\n
revm	[remu]\n▪<i><font face='mono'>n.</font></i>\ndream: <i><font color='#404040'>Sos yor yanje revm na endia revm yehah revm&nbsp;&nbsp;—<font size='1'>EXEC_HARMONIOUS_FUSION/.</font></font></i>\n\n<b>&lt;DIALECT&gt;</b> Central Standard Note\n
ridalnae	[ridaruna^e]\n▪<i><font face='mono'>adj.</font></i>\nirreplaceable\n\n<b>&lt;DIALECT&gt;</b> Metafalss Note\n
rifaiah	[?]\n▪<i><font face='mono'>adjective, adverb</font></i>\nborne of revival \n\n<b>&lt;DIALECT&gt;</b> Unknown [Unofficial]\n
rifaien	[ri^faien]\n▪<i><font face='mono'>v.</font></i>\nresurrect, revive: <i><font color='#404040'>Presia metafalica rifaien tou yor sphilar&nbsp;&nbsp;—<font size='1'>EXEC_HARMONIOUS</font></font></i>\n\n<b>&lt;DIALECT&gt;</b> Metafalss Note\n
rinc	[?]\n▪<i><font face='mono'>v.</font></i>\nsynchronize, feel the same: <i><font color='#404040'>Rrha yea ra rinc en echrra yor rre walasye jyel got ieeya&nbsp;&nbsp;—<font size='1'>Singing Hill - Harmonics FRELIA </font></font></i>\n\n<b>&lt;DIALECT&gt;</b> Unknown [Unofficial]\n
riomo	[rio^mo]\n▪<i><font face='mono'>v.</font></i>\nto give a, to present a (thing, condition, state): <i><font color='#404040'>herra pagle harr riomo hueaf&nbsp;&nbsp;—<font size='1'>EXEC_METAFALICA/.</font></font></i>\n\n<b>&lt;DIALECT&gt;</b> Cluster Note\n
rippllys	[ripurisu]\n▪<i><font face='mono'>n./v.</font></i>\nreply, answer: <i><font color='#404040'>whai yorr na rippllys mea&nbsp;&nbsp;—<font size='1'>EXEC_HARMONIOUS_FUSION/.</font></font></i>\n\n<b>&lt;DIALECT&gt;</b> Central Standard Note\n
riura	[?]\n▪<i><font face='mono'>noun</font></i>\nface, facial expression \n\n<b>&lt;DIALECT&gt;</b> Unknown [Unofficial]\n
rivire	[rivire]\n▪<i><font face='mono'>n.</font></i>\nriver: <i><font color='#404040'>rivire plina fayra clalliss sphilar&nbsp;&nbsp;—<font size='1'>Colors~SEN~Will This Flower Bloom? 	</font></font></i>\n\n<b>&lt;DIALECT&gt;</b> Central Standard Note\n
riya	[?]\n▪<i><font face='mono'>n.</font></i>\nsincerity\n\n<b>&lt;DIALECT&gt;</b> Unknown [Unofficial]\n
rol	[roru]\n▪<i><font face='mono'>conj.</font></i>\nas if, like: <i><font color='#404040'>Hyear whai yorra vit rol hierle&nbsp;&nbsp;—<font size='1'>EXEC_HARMONIOUS_FUSION/.</font></font></i>\n\n<b>&lt;DIALECT&gt;</b> Central Standard Note\n
roon	[?]\n▪<i><font face='mono'>noun</font></i>\nmansion \n\n<b>&lt;DIALECT&gt;</b> Unknown [Unofficial]\n
rooshellan	[?]\n▪<i><font face='mono'>noun</font></i>\ncradle \n\n<b>&lt;DIALECT&gt;</b> Unknown [Unofficial]\n
rosa	[rosa]\n▪<i><font face='mono'>n.</font></i>\nrose, rose petal: <i><font color='#404040'>rudje en rudje rosa&nbsp;&nbsp;—<font size='1'>EXEC_HARMONIOUS_FUSION/.</font></font></i>\n\n<b>&lt;DIALECT&gt;</b> Central Standard Note\n
rre	[re]\n▪<i><font face='mono'>pre</font></i>\n(subject marker): <i><font color='#404040'>Wee ki ra ene rre sor hymme ar ciel en rre hymmnos ee powel&nbsp;&nbsp;—<font size='1'>Singing Hill - Harmonics FRELIA </font></font></i>\n\n<b>&lt;DIALECT&gt;</b> Central Standard Note\n
rudje	[rujie]\n▪<i><font face='mono'>adj./n.</font></i>\nred, scarlet, crimson: <i><font color='#404040'>x. rre omness a.u.k. zodaw ess rudje noglle doodu&nbsp;&nbsp;—<font size='1'>EXEC_over.METHOD_SUBLIMATION/.~lamenza</font></font></i>\n\n<b>&lt;DIALECT&gt;</b> Central Standard Note\n
ruinie	[ruinie]\n▪<i><font face='mono'>v.</font></i>\ndestroy: <i><font color='#404040'>zadius guatrz ruinie&nbsp;&nbsp;—<font size='1'>Colors~SEN~Will This Flower Bloom? 	</font></font></i>\n\n<b>&lt;DIALECT&gt;</b> Central Standard Note\n
ruinien	[?]\n▪<i><font face='mono'>n.</font></i>\ndestruction: <i><font color='#404040'>Hyear Ma num ra gyusya yorr ee Dia oz ruinien&nbsp;&nbsp;—<font size='1'>EXEC_DESPEDIA/.</font></font></i>\n\n<b>&lt;DIALECT&gt;</b> Unknown [Unofficial]\n
rum	[?]\n▪<i><font face='mono'>n.</font></i>\nflame: <i><font color='#404040'>Presia yehar zadius rum ferda yor der sarla mea&nbsp;&nbsp;—<font size='1'>EXEC_HARMONIOUS</font></font></i>\n\n<b>&lt;DIALECT&gt;</b> Unknown [Unofficial]\n
ryewa	[riewa]\n▪<i><font face='mono'>adj.</font></i>\novergrown: <i><font color='#404040'>ar w.r.l. du cia dn ryewa keg&nbsp;&nbsp;—<font size='1'>METHOD_METAFALICA/.</font></font></i>\n\n<b>&lt;DIALECT&gt;</b> New Testament of Pastalie\n
ryushe	[?]\n▪<i><font face='mono'>verb</font></i>\ndepart on a journey \n\n<b>&lt;DIALECT&gt;</b> Unknown [Unofficial]\n
ryusse	[ryu^ji^]\n▪<i><font face='mono'>n.</font></i>\njourney, trip\n\n<b>&lt;DIALECT&gt;</b> Cult Ciel Note\n
s.l.	[shiru]\n▪<i><font face='mono'>E.v.</font></i>\nbelieve, trust: <i><font color='#404040'>x. rre s.l. sphaela arhou&nbsp;&nbsp;—<font size='1'>METHOD_REPLEKIA/.</font></font></i>\n\n<b>&lt;DIALECT&gt;</b> New Testament of Pastalie\n
s.l.y.	[?]\n▪<i><font face='mono'>E.v.</font></i>\ngive, award, convey: <i><font color='#404040'>sev x. rre yorr s.l.y. nafan mea&nbsp;&nbsp;—<font size='1'>METHOD_METAFALICA/.</font></font></i>\n\n<b>&lt;DIALECT&gt;</b> Pastalie [Unofficial]\n
s.n.k.k.	[sunku]\n▪<i><font face='mono'>E.v.</font></i>\nbud (plant): <i><font color='#404040'>x. rre s.n.k.k. mirie ag h.m.m.r. eje&nbsp;&nbsp;—<font size='1'>METHOD_REPLEKIA/.</font></font></i>\n\n<b>&lt;DIALECT&gt;</b> New Testament of Pastalie\n
s.s.w.	[su^u]\n▪<i><font face='mono'>E.v.</font></i>\nsay, speak, inform\n\n<b>&lt;DIALECT&gt;</b> New Testament of Pastalie\n
sa	[sa]\n▪<i><font face='mono'>n.</font></i>\nkarma\n\n<b>&lt;DIALECT&gt;</b> Central Standard Note\n
saash	[sa^shu]\n▪<i><font face='mono'>n.</font></i>\nGod, gods: <i><font color='#404040'>Rrha ki ra sarrifis mea noes tes inferiare saash&nbsp;&nbsp;—<font size='1'>EXEC_SOL=FAGE/.</font></font></i>\n\n<b>&lt;DIALECT&gt;</b> Central Standard Note\n
sabl	[saburu]\n▪<i><font face='mono'>n.</font></i>\nsand: <i><font color='#404040'>ween sabl den fandel sabl&nbsp;&nbsp;—<font size='1'>EXEC_METAFALICA/.</font></font></i>\n\n<b>&lt;DIALECT&gt;</b> Central Standard Note\n
sacra	[?]\n▪<i><font face='mono'>n.</font></i>\nblood: <i><font color='#404040'>der sacra rol fau ween leaff&nbsp;&nbsp;—<font size='1'>EXEC_HARMONIOUS_FUSION/.</font></font></i>\n\n<b>&lt;DIALECT&gt;</b> Unknown [Unofficial]\n
sallogna	[saroguna]\n▪<i><font face='mono'>v.</font></i>\nlie down, stretch, rest\n\n<b>&lt;DIALECT&gt;</b> Central Standard Note\n
sanctum	[sankutoumu]\n▪<i><font face='mono'>n.</font></i>\nark: <i><font color='#404040'>spiritum sanctum&nbsp;&nbsp;—<font size='1'>EXEC_METAFALICA/.</font></font></i>\n\n<b>&lt;DIALECT&gt;</b> Central Standard Note\n
sar	[sa^]\n▪<i><font face='mono'>n.</font></i>\nsky (Note: Word crafted by Shurelia for Phantasmagoria, because of the problem that represented the use of "ciel" given its two meanings).: <i><font color='#404040'>Wee yea ra enne ar sar Wee yea ra enne ar dor&nbsp;&nbsp;—<font size='1'>EXEC_PHANTASMAGORIA/.</font></font></i>\n\n<b>&lt;DIALECT&gt;</b> Alpha Note (EOLIA)\n
sara	[sara]\n▪<i><font face='mono'>n.</font></i>\ngrass: <i><font color='#404040'>sara dorn fhyu hymma&nbsp;&nbsp;—<font size='1'>Singing Hill</font></font></i>\n\n<b>&lt;DIALECT&gt;</b> Central Standard Note\n
sarla	[sarura]\n▪<i><font face='mono'>n.</font></i>\nsong: <i><font color='#404040'>ween shellan yorra accroad mea sarla oz enne&nbsp;&nbsp;—<font size='1'>EXEC_HARMONIOUS_FUSION/.</font></font></i>\n\n<b>&lt;DIALECT&gt;</b> Metafalss Note\n
sarr	[sa^ru]\n▪<i><font face='mono'>n.</font></i>\nsunlight, radiance: <i><font color='#404040'>x. rre sarr m.n.g. du tyui lyuma&nbsp;&nbsp;—<font size='1'>EXEC_over.METHOD_SUBLIMATION/.~omness chs ciel sos infel</font></font></i>\n\n<b>&lt;DIALECT&gt;</b> New Testament of Pastalie\n
sarrifis	[sarifisu]\n▪<i><font face='mono'>v.</font></i>\noffer (a sacrifice): <i><font color='#404040'>Rrha ki ra sarrifis mea noes tes inferiare saash&nbsp;&nbsp;—<font size='1'>EXEC_SOL=FAGE/.</font></font></i>\n\n<b>&lt;DIALECT&gt;</b> Central Standard Note\n
sarsa	[sa^sa]\n▪<i><font face='mono'>n.</font></i>\nrain\n\n<b>&lt;DIALECT&gt;</b> New Testament of Pastalie\n
sash	[?]\n▪<i><font face='mono'>v.</font></i>\nscatter: <i><font color='#404040'>sash fwillra ween papana&nbsp;&nbsp;—<font size='1'>EXEC_SPHILIA/.</font></font></i>\n\n<b>&lt;DIALECT&gt;</b> Unknown [Unofficial]\n
sasye	[sashie]\n▪<i><font face='mono'>n.</font></i>\ngirl, young woman: <i><font color='#404040'>Ides rre sasye Rhaplanca&nbsp;&nbsp;—<font size='1'>EXEC_METAFALICA/.</font></font></i>\n\n<b>&lt;DIALECT&gt;</b> Central Standard Note\n
savath	[sa^basu]\n▪<i><font face='mono'>v.</font></i>\nsurge, gush out\n\n<b>&lt;DIALECT&gt;</b> Cult Ciel Note\n
sechel	[sekeru]\n▪<i><font face='mono'>n.</font></i>\ncity: <i><font color='#404040'>x. rre h.m.m.r. byui q.l.s. du sechel&nbsp;&nbsp;—<font size='1'>METHOD_REPLEKIA/.</font></font></i>\n\n<b>&lt;DIALECT&gt;</b> New Testament of Pastalie\n
sefanl	[sefanru]\n▪<i><font face='mono'>n.</font></i>\nforest: <i><font color='#404040'>ag t.n. za v.t. dn balduo sefanl&nbsp;&nbsp;—<font size='1'>EXEC_over.METHOD_SUBLIMATION/.~omness chs ciel sos infel</font></font></i>\n\n<b>&lt;DIALECT&gt;</b> New Testament of Pastalie\n
selena	[serena]\n▪<i><font face='mono'>v.</font></i>\nplay (a instrument): <i><font color='#404040'>Was ki ra selena anw hymmnos PAJA&nbsp;&nbsp;—<font size='1'>EXEC_PURGER/.#Misha extracting</font></font></i>\n\n<b>&lt;DIALECT&gt;</b> Metafalss Note\n
sephaje	[?]\n▪<i><font face='mono'>n.</font></i>\ncreation of the world\n\n<b>&lt;DIALECT&gt;</b> Unknown [Unofficial]\n
sev	[sevu]\n▪<i><font face='mono'>conj.</font></i>\nat the time of ~, when ~: <i><font color='#404040'>sev x. rre yorr s.l.y. nafan mea&nbsp;&nbsp;—<font size='1'>METHOD_METAFALICA/.</font></font></i>\n\n<b>&lt;DIALECT&gt;</b> New Testament of Pastalie\n
sguela	[?]\n▪<i><font face='mono'>adjective</font></i>\nprecious, important \n\n<b>&lt;DIALECT&gt;</b> Unknown [Unofficial]\n
shazra	[shazura]\n▪<i><font face='mono'>n.</font></i>\nthorny vine, thorn, thorny shrub (Note: Used only for plants that have thorns): <i><font color='#404040'>Rrha paks ra chs shazra cause yor&nbsp;&nbsp;—<font size='1'>EXEC_DESPEDIA/.</font></font></i>\n\n<b>&lt;DIALECT&gt;</b> Central Standard Note\n
sheak	[shieaku]\n▪<i><font face='mono'>n.</font></i>\nsun: <i><font color='#404040'>Was yea ra yasra sheak&nbsp;&nbsp;—<font size='1'>EXEC_HIBERNATION/.</font></font></i>\n\n<b>&lt;DIALECT&gt;</b> Cult Ciel Note\n
sheaken	[?]\n▪<i><font face='mono'>n.</font></i>\nleft\n\n<b>&lt;DIALECT&gt;</b> Unknown [Unofficial]\n
shefra	[?]\n▪<i><font face='mono'>n.</font></i>\ncreation of the world\n\n<b>&lt;DIALECT&gt;</b> Unknown [Unofficial]\n
shell	[?]\n▪<i><font face='mono'>n.</font></i>\n(inside a) shell: <i><font color='#404040'>Yorr ween shell&nbsp;&nbsp;—<font size='1'>EXEC_SPHILIA/.</font></font></i>\n\n<b>&lt;DIALECT&gt;</b> Unknown [Unofficial]\n
shellan	[shieran]\n▪<i><font face='mono'>n.</font></i>\nbirdcage, cage, basket, pen: <i><font color='#404040'>ween shellan yorra accroad mea sarla oz enne&nbsp;&nbsp;—<font size='1'>EXEC_HARMONIOUS_FUSION/.</font></font></i>\n\n<b>&lt;DIALECT&gt;</b> Metafalss Note\n
shen	[shien]\n▪<i><font face='mono'>n.</font></i>\nlight: <i><font color='#404040'>en shen titilia mea spiritum&nbsp;&nbsp;—<font size='1'>EXEC_SOL=FAGE/.</font></font></i>\n\n<b>&lt;DIALECT&gt;</b> Central Standard Note\n
shyun	[?]\n▪<i><font face='mono'>adjective, noun</font></i>\nsadness, grief \n\n<b>&lt;DIALECT&gt;</b> Unknown [Unofficial]\n
sial	[sharu]\n▪<i><font face='mono'>adj.</font></i>\na bit, a little: <i><font color='#404040'>Was ki ra na fogabe anw sial gyaje&nbsp;&nbsp;—<font size='1'>EXEC_over.METHOD_SUBLIMATION/.~omness chs ciel sos infel</font></font></i>\n\n<b>&lt;DIALECT&gt;</b> Central Standard Note\n
siance	[shanshie]\n▪<i><font face='mono'>n.</font></i>\nholy land, sanctuary, utopia\n\n<b>&lt;DIALECT&gt;</b> New Testament of Pastalie\n
siann	[shan]\n▪<i><font face='mono'>n.</font></i>\nlight (Note: if it's preceeded by a "LYA" emotion vowel, its meaning changes to "Maiden of Homura"): <i><font color='#404040'>x. harr t.h.s. siann&nbsp;&nbsp;—<font size='1'>METHOD_REPLEKIA/.</font></font></i>\n\n<b>&lt;DIALECT&gt;</b> New Testament of Pastalie\n
sielp	[shierupu]\n▪<i><font face='mono'>n.</font></i>\nbrook, murmur: <i><font color='#404040'>chs hasyu en zassyen der sielp&nbsp;&nbsp;—<font size='1'>EXEC_over.METHOD_SUBLIMATION/.~omness chs ciel sos infel</font></font></i>\n\n<b>&lt;DIALECT&gt;</b> Central Standard Note\n
sik	[shiku]\n▪<i><font face='mono'>v.</font></i>\nleave, move away from\n\n<b>&lt;DIALECT&gt;</b> Cult Ciel Note\n
siss	[?]\n▪<i><font face='mono'>v.</font></i>\nerase, put out, eliminate: <i><font color='#404040'>na siss cupla&nbsp;&nbsp;—<font size='1'>EXEC_SPHILIA/.</font></font></i>\n\n<b>&lt;DIALECT&gt;</b> Unknown [Unofficial]\n
skit	[sukitto]\n▪<i><font face='mono'>v.</font></i>\npromise\n\n<b>&lt;DIALECT&gt;</b> Cult Ciel Note\n
slep	[surepu]\n▪<i><font face='mono'>v.</font></i>\nsleep: <i><font color='#404040'>Ma num ra slep faura etealune na dauan&nbsp;&nbsp;—<font size='1'>EXEC_HIBERNATION/.</font></font></i>\n\n<b>&lt;DIALECT&gt;</b> Central Standard Note\n
slepir	[surepia]\n▪<i><font face='mono'>v.</font></i>\nput to sleep, stop (an activity): <i><font color='#404040'>Rrha num ra slepir etealune na near na morto ciel&nbsp;&nbsp;—<font size='1'>EXEC_HIBERNATION/.</font></font></i>\n\n<b>&lt;DIALECT&gt;</b> Metafalss Note\n
so	[?]\n▪<i><font face='mono'>conj.</font></i>\nin such a way, so much: <i><font color='#404040'>Yorr faf so&nbsp;&nbsp;—<font size='1'>EXEC_SPHILIA/.</font></font></i>\n\n<b>&lt;DIALECT&gt;</b> Unknown [Unofficial]\n
soare	[?]\n▪<i><font face='mono'>n.</font></i>\nsong, prayer: <i><font color='#404040'>Wee ki ra araus tes soare en giue mea iem&nbsp;&nbsp;—<font size='1'>EXEC_CHRONICLE KEY</font></font></i>\n\n<b>&lt;DIALECT&gt;</b> Unknown [Unofficial]\n
sol	[soru]\n▪<i><font face='mono'>v.</font></i>\n(daylight) shines, shine down brilliantly (Note: However, the phrase "Sol Ciel" refers to the region of the first Ar tonelico tower, and was to be used as the name of the world. It's because there was already a phrase in Central Standard Note for this world, "Ar Ciel", that "Sol Ciel" ended becoming only the name of the region of the first tower. That region owes its name to the Ancient Metafalss Note.): <i><font color='#404040'>Faura yerwe murfan anw sol ciel&nbsp;&nbsp;—<font size='1'>EXEC_HARMONIOUS_FUSION/.</font></font></i>\n\n<b>&lt;DIALECT&gt;</b> Metafalss Note\n
sonwe	[son'ue]\n▪<i><font face='mono'>v.</font></i>\nsing: <i><font color='#404040'>Faura sonwe murfan anw sol ciel ee&nbsp;&nbsp;—<font size='1'>EXEC_HARMONIOUS_FUSION/.</font></font></i>\n\n<b>&lt;DIALECT&gt;</b> Metafalss Note\n
sor	[soa]\n▪<i><font face='mono'>pro.</font></i>\nthat: <i><font color='#404040'>Wee ki ra ene rre sor hymme ar ciel en rre hymmnos ee powel&nbsp;&nbsp;—<font size='1'>Singing Hill - Harmonics FRELIA </font></font></i>\n\n<b>&lt;DIALECT&gt;</b> Central Standard Note\n
sorr it	\n▪<i><font face='mono'>conj.</font></i>\nit's that way\n\n<b>&lt;DIALECT&gt;</b> \n
sorra it	\n▪<i><font face='mono'>conj.</font></i>\nin those ways,\n\n<b>&lt;DIALECT&gt;</b> \n
sos	[sosu]\n▪<i><font face='mono'>conj.</font></i>\nfor, because of, for the sake of: <i><font color='#404040'>Rrha ki ra enne sos yor&nbsp;&nbsp;—<font size='1'>EXEC_SOL=FAGE/.</font></font></i>\n\n<b>&lt;DIALECT&gt;</b> Central Standard Note\n
sosar	[sosaru]\n▪<i><font face='mono'>n.</font></i>\nmagic, magical power (Note: Even if the magic that manifests through Hymmnos is called "maya", actually the spells have a much more specialized image. "maya" has a nuance of miracles made by the power of the gods, while sosar... its more similar to standard sorcery).: <i><font color='#404040'>Was yea ra enne en crushue gyen METAFALICA ee sosar&nbsp;&nbsp;—<font size='1'>Singing Hill - Harmonics FRELIA </font></font></i>\n\n<b>&lt;DIALECT&gt;</b> Central Standard Note\n
sphaela	[sufaiera]\n▪<i><font face='mono'>n.</font></i>\nworld: <i><font color='#404040'>vega ouvyu giz sphaela&nbsp;&nbsp;—<font size='1'>METHOD_REPLEKIA/.</font></font></i>\n\n<b>&lt;DIALECT&gt;</b> New Testament of Pastalie\n
sphilar	[sufi^ra]\n▪<i><font face='mono'>n.</font></i>\nmind, spirit: <i><font color='#404040'>l.n.c.a. w.w.j.n.c. syec sphilar&nbsp;&nbsp;—<font size='1'>jy ra cc ci ce je xa jy r acc ci ce je xa rcc jy ra cc ar foul</font></font></i>\n\n<b>&lt;DIALECT&gt;</b> Metafalss Note\n
spiritum	[supiritoumu]\n▪<i><font face='mono'>adj./n.</font></i>\nsoul, of the soul: <i><font color='#404040'>Wee yea ra hymme spiritum&nbsp;&nbsp;—<font size='1'>Singing Hill - Harmonics FRELIA </font></font></i>\n\n<b>&lt;DIALECT&gt;</b> Central Standard Note\n
spitze	[shupittsue]\n▪<i><font face='mono'>n.</font></i>\nfreedom\n\n<b>&lt;DIALECT&gt;</b> Central Standard Note\n
ssvid	[?]\n▪<i><font face='mono'>v.</font></i>\noutlive: <i><font color='#404040'>x. rre qejyu ssvid hiralg ag xevxl&nbsp;&nbsp;—<font size='1'>METHOD_METAFALICA/.</font></font></i>\n\n<b>&lt;DIALECT&gt;</b> Unknown [Unofficial]\n
stel	[suteru]\n▪<i><font face='mono'>v.</font></i>\ntake, steal, snatch away (Note: Used when one takes something from other person by force. Used usually by the one that lost the stolen thing): <i><font color='#404040'>Rrha wol ra stel naja getrra faura anw dornpica&nbsp;&nbsp;—<font size='1'>EXEC_HIBERNATION/.</font></font></i>\n\n<b>&lt;DIALECT&gt;</b> Central Standard Note\n
stelled	[suteredo]\n▪<i><font face='mono'>v.</font></i>\ncompete, struggle for (Note: Used for fierce battles or competitions. Used usually by the loser.)\n\n<b>&lt;DIALECT&gt;</b> Central Standard Note\n
suwant	[suwanto]\n▪<i><font face='mono'>v.</font></i>\nsave, rescue, help: <i><font color='#404040'>Was paks ga suwant mea irs here an yor&nbsp;&nbsp;—<font size='1'>EXEC_with.METHOD_METAFALICA/.</font></font></i>\n\n<b>&lt;DIALECT&gt;</b> Central Standard Note\n
swant	\n▪<i><font face='mono'>v.</font></i>\nhelp, save, rescue\n\n<b>&lt;DIALECT&gt;</b> Central\n
syalea	[?]\n▪<i><font face='mono'>n.</font></i>\ndecision, resolve: <i><font color='#404040'>w.w.j.n.c. syalea en zz kvvia&nbsp;&nbsp;—<font size='1'>METHOD_METAFALICA/.</font></font></i>\n\n<b>&lt;DIALECT&gt;</b> Unknown [Unofficial]\n
syana	[?]\n▪<i><font face='mono'>noun, verb</font></i>\necho, resound \n\n<b>&lt;DIALECT&gt;</b> Unknown [Unofficial]\n
syast	[shasuto]\n▪<i><font face='mono'>v.</font></i>\ncongregate, gather: <i><font color='#404040'>Wee yea ra hymme hymmnos harmon en syast et wi powel&nbsp;&nbsp;—<font size='1'>Singing Hill - Harmonics FRELIA </font></font></i>\n\n<b>&lt;DIALECT&gt;</b> Central Standard Note\n
syec	[seku]\n▪<i><font face='mono'>n.</font></i>\nabyss, depths (Note: Not used to refer to a physical abyss, but rather to a mental one. This word is usually used to represent the Soulspace).: <i><font color='#404040'>Ma ki ga ks maya yor syec&nbsp;&nbsp;—<font size='1'>Singing Hill</font></font></i>\n\n<b>&lt;DIALECT&gt;</b> Cult Ciel Note\n
syezo	[?]\n▪<i><font face='mono'>noun</font></i>\nsoup \n\n<b>&lt;DIALECT&gt;</b> Unknown [Unofficial]\n
synk	[shinku]\n▪<i><font face='mono'>v.</font></i>\noverlap, pile up: <i><font color='#404040'>Rrha ki ra synk cexm dius lusye&nbsp;&nbsp;—<font size='1'>EXEC_METAFALICA/.</font></font></i>\n\n<b>&lt;DIALECT&gt;</b> Central Standard Note\n
syunaht	[shunatto]\n▪<i><font face='mono'>verb</font></i>\ndissolve, scatter, vanish \n\n<b>&lt;DIALECT&gt;</b> Cult Ciel Note\n
t.h.s.	[?]\n▪<i><font face='mono'>E.v.</font></i>\ngo outside: <i><font color='#404040'>x. harr t.h.s. siann&nbsp;&nbsp;—<font size='1'>METHOD_REPLEKIA/.</font></font></i>\n\n<b>&lt;DIALECT&gt;</b> Pastalie [Unofficial]\n
t.k.d.	[tokuto]\n▪<i><font face='mono'>v.</font></i>\nreach: <i><font color='#404040'>y.z.t. za rre vega f.s. t.k.d. ag zz t.k.d. tie hartes yor&nbsp;&nbsp;—<font size='1'>METHOD_METAFALICA/.</font></font></i>\n\n<b>&lt;DIALECT&gt;</b> New Testament of Pastalie\n
t.n.	[toun]\n▪<i><font face='mono'>v.</font></i>\nstop, end: <i><font color='#404040'>ag t.n. za v.t. dn balduo sefanl&nbsp;&nbsp;—<font size='1'>EXEC_over.METHOD_SUBLIMATION/.~omness chs ciel sos infel</font></font></i>\n\n<b>&lt;DIALECT&gt;</b> New Testament of Pastalie\n
t.n.m.n.	[tonmun]\n▪<i><font face='mono'>v.</font></i>\nscatter (seeds), (to) plant: <i><font color='#404040'>x. rre rhaplanca t.n.m.n. poe ess gkgul doodu&nbsp;&nbsp;—<font size='1'>METHOD_METAFALICA/.</font></font></i>\n\n<b>&lt;DIALECT&gt;</b> New Testament of Pastalie\n
t.r.m.	[torumu]\n▪<i><font face='mono'>v.</font></i>\ndevelop, make bloom, realize: <i><font color='#404040'>t.r.m.&nbsp;&nbsp;—<font size='1'>jy ra cc ci ce je xa jy r acc ci ce je xa rcc jy ra cc ar foul</font></font></i>\n\n<b>&lt;DIALECT&gt;</b> New Testament of Pastalie\n
tafane	[?]\n▪<i><font face='mono'>adj.</font></i>\nglittering, sparkling: <i><font color='#404040'>x. harr m.r.r. aje tafane sphaela&nbsp;&nbsp;—<font size='1'>METHOD_REPLEKIA/.</font></font></i>\n\n<b>&lt;DIALECT&gt;</b> Pastalie [Unofficial]\n
talam	[ta^ran]\n▪<i><font face='mono'>adj.</font></i>\ndawn's color: <i><font color='#404040'>x. rre cia n.m.l. ut talam ag f.r.l. du tussu&nbsp;&nbsp;—<font size='1'>EXEC_over.METHOD_SUBLIMATION/.~omness chs ciel sos infel</font></font></i>\n\n<b>&lt;DIALECT&gt;</b> New Testament of Pastalie\n
tanta	[tanta]\n▪<i><font face='mono'>v.</font></i>\ndance\n\n<b>&lt;DIALECT&gt;</b> Central Standard Note\n
tapa	[tapa]\n▪<i><font face='mono'>n.</font></i>\nwater\n\n<b>&lt;DIALECT&gt;</b> New Testament of Pastalie\n
tarfe	[ta^fe]\n▪<i><font face='mono'>v.</font></i>\nstop, halt: <i><font color='#404040'>en tarfe tou yos maun&nbsp;&nbsp;—<font size='1'>EXEC_over.METHOD_SUBLIMATION/.~omness chs ciel sos infel</font></font></i>\n\n<b>&lt;DIALECT&gt;</b> Central Standard Note\n
targue	[ta^gue]\n▪<i><font face='mono'>conj.</font></i>\neven if ~ is the case: <i><font color='#404040'>targue rre qejyu z.z.x.&nbsp;&nbsp;—<font size='1'>EXEC_over.METHOD_SUBLIMATION/.~omness chs ciel sos infel</font></font></i>\n\n<b>&lt;DIALECT&gt;</b> New Testament of Pastalie\n
tasyue	[ta^shue]\n▪<i><font face='mono'>v.</font></i>\noffer, sacrifice: <i><font color='#404040'>Rrha ki ra tasyue murfanare sos saash&nbsp;&nbsp;—<font size='1'>EXEC_SOL=FAGE/.</font></font></i>\n\n<b>&lt;DIALECT&gt;</b> Metafalss Note\n
tatakaria	[?]\n▪<i><font face='mono'>noun</font></i>\nexistences, beings, lives \n\n<b>&lt;DIALECT&gt;</b> Unknown [Unofficial]\n
tek	[teku]\n▪<i><font face='mono'>v.</font></i>\nGo: <i><font color='#404040'>Rrha ki ra tek wim tes yor&nbsp;&nbsp;—<font size='1'>EXEC_LINKER</font></font></i>\n\n<b>&lt;DIALECT&gt;</b> Central Standard Note\n
tes	[tesu]\n▪<i><font face='mono'>conj.</font></i>\nat ~, to ~: <i><font color='#404040'>Rrha ki ra sarrifis mea noes tes inferiare saash&nbsp;&nbsp;—<font size='1'>EXEC_SOL=FAGE/.</font></font></i>\n\n<b>&lt;DIALECT&gt;</b> Central Standard Note\n
teyys	[teisu]\n▪<i><font face='mono'>v.</font></i>\nhalt, remain, exist, stay (Note: Equivalent to the English "stay"): <i><font color='#404040'>Ma num ra teyys ween syec oz wase en noglle guatrz ee&nbsp;&nbsp;—<font size='1'>EXEC_DESPEDIA/.</font></font></i>\n\n<b>&lt;DIALECT&gt;</b> Central Standard Note\n
ther	[jia]\n▪<i><font face='mono'>conj.</font></i>\nthat\n\n<b>&lt;DIALECT&gt;</b> Central Standard Note\n
tictim	[teikuteimu]\n▪<i><font face='mono'>v.</font></i>\ncontrol, operate, do as one pleases: <i><font color='#404040'>Ma num ra tictim yorr wis kneet hueaf van yorr zaffur&nbsp;&nbsp;—<font size='1'>EXEC_DESPEDIA/.</font></font></i>\n\n<b>&lt;DIALECT&gt;</b> Central Standard Note\n
tie	[teie]\n▪<i><font face='mono'>conj.</font></i>\nin regards to... (specifying a subject): <i><font color='#404040'>Rrha ki ra tie yor ini en nha&nbsp;&nbsp;—<font size='1'>Singing Hill</font></font></i>\n\n<b>&lt;DIALECT&gt;</b> New Testament of Pastalie\n
tienar	[?]\n▪<i><font face='mono'>adverb</font></i>\nwithout stopping, without end \n\n<b>&lt;DIALECT&gt;</b> Unknown [Unofficial]\n
tilanta	[?]\n▪<i><font face='mono'>verb</font></i>\nflow into \n\n<b>&lt;DIALECT&gt;</b> Unknown [Unofficial]\n
tim	[?]\n▪<i><font face='mono'>n.</font></i>\ntime: <i><font color='#404040'>Whalt tim 0 chs Diasee&nbsp;&nbsp;—<font size='1'>EXEC_LINKER</font></font></i>\n\n<b>&lt;DIALECT&gt;</b> Unknown [Unofficial]\n
titia	[teiteia]\n▪<i><font face='mono'>n.</font></i>\ngood will, innate goodness of man: <i><font color='#404040'>x. rre w.r.m. maen a.u.k. zess titia&nbsp;&nbsp;—<font size='1'>METHOD_REPLEKIA/.</font></font></i>\n\n<b>&lt;DIALECT&gt;</b> New Testament of Pastalie\n
titil	[teiteiru]\n▪<i><font face='mono'>n.</font></i>\nsmall things, accesories: <i><font color='#404040'>titil yehah presia yorr wis yehah presia yanje&nbsp;&nbsp;—<font size='1'>EXEC_HARMONIOUS_FUSION/.</font></font></i>\n\n<b>&lt;DIALECT&gt;</b> Cult Ciel Note\n
titilia	[teiteiria]\n▪<i><font face='mono'>adj.</font></i>\nsmall, little, tiny: <i><font color='#404040'>en shen titilia mea spiritum&nbsp;&nbsp;—<font size='1'>EXEC_SOL=FAGE/.</font></font></i>\n\n<b>&lt;DIALECT&gt;</b> Cult Ciel Note\n
toe	[?]\n▪<i><font face='mono'>adjective, verb</font></i>\nrise above, stand over \n\n<b>&lt;DIALECT&gt;</b> Unknown [Unofficial]\n
tonelico	[?]\n▪<i><font face='mono'>n.</font></i>\ndivine tree, (possible alternate meaning: tower): <i><font color='#404040'>Synk sor al memora en knawa Ar tonelico&nbsp;&nbsp;—<font size='1'>EXEC_LINKER</font></font></i>\n\n<b>&lt;DIALECT&gt;</b> Unknown [Unofficial]\n
tou	[tou]\n▪<i><font face='mono'>conj.</font></i>\nat ~, in ~, to ~: <i><font color='#404040'>en tarfe tou yos maun&nbsp;&nbsp;—<font size='1'>EXEC_over.METHOD_SUBLIMATION/.~omness chs ciel sos infel</font></font></i>\n\n<b>&lt;DIALECT&gt;</b> Central Standard Note\n
touwaka	[touwaka]\n▪<i><font face='mono'>E.s. II</font></i>\nwishful, hiding wishes in my heart: <i><font color='#404040'>Nnoi crown touwaka arsye yor&nbsp;&nbsp;—<font size='1'>The Heart Speaks</font></font></i>\n\n<b>&lt;DIALECT&gt;</b> Central Standard Note\n
trina	[?]\n▪<i><font face='mono'>verb</font></i>\nnotice, become aware \n\n<b>&lt;DIALECT&gt;</b> Unknown [Unofficial]\n
ttu	[tsutou]\n▪<i><font face='mono'>conj.</font></i>\nin order to do ~\n\n<b>&lt;DIALECT&gt;</b> New Testament of Pastalie\n
ture	[?]\n▪<i><font face='mono'>n.</font></i>\nbonds: <i><font color='#404040'>Ridalnae ture inferiare manaf&nbsp;&nbsp;—<font size='1'>EXEC_HARMONIOUS</font></font></i>\n\n<b>&lt;DIALECT&gt;</b> Unknown [Unofficial]\n
tussu	[toussu]\n▪<i><font face='mono'>n.</font></i>\nchange: <i><font color='#404040'>x. rre cia n.m.l. ut talam ag f.r.l. du tussu&nbsp;&nbsp;—<font size='1'>EXEC_over.METHOD_SUBLIMATION/.~omness chs ciel sos infel</font></font></i>\n\n<b>&lt;DIALECT&gt;</b> New Testament of Pastalie\n
tyui	[touyui]\n▪<i><font face='mono'>adj.</font></i>\nSmall, little, tiny: <i><font color='#404040'>x. rre sarr m.n.g. du tyui lyuma&nbsp;&nbsp;—<font size='1'>EXEC_over.METHOD_SUBLIMATION/.~omness chs ciel sos infel</font></font></i>\n\n<b>&lt;DIALECT&gt;</b> New Testament of Pastalie\n
tyuss	[?]\n▪<i><font face='mono'>adj.</font></i>\ntender, kind: <i><font color='#404040'>y.y. en tyuss vl omness&nbsp;&nbsp;—<font size='1'>METHOD_METAFALICA/.</font></font></i>\n\n<b>&lt;DIALECT&gt;</b> Pastalie [Unofficial]\n
ugi	[u^ji]\n▪<i><font face='mono'>v.</font></i>\ndecide: <i><font color='#404040'>Den crown ugi arsye mea&nbsp;&nbsp;—<font size='1'>The Heart Speaks</font></font></i>\n\n<b>&lt;DIALECT&gt;</b> Cult Ciel Note\n
uje	[?]\n▪<i><font face='mono'>adj.</font></i>\ncruel, evil\n\n<b>&lt;DIALECT&gt;</b> Unknown [Unofficial]\n
ujes	[ujiesu]\n▪<i><font face='mono'>n.</font></i>\nill will: <i><font color='#404040'>x. sorr m.r.r. du daedu ag ujes&nbsp;&nbsp;—<font size='1'>METHOD_REPLEKIA/.</font></font></i>\n\n<b>&lt;DIALECT&gt;</b> New Testament of Pastalie\n
unloee	[anroi]\n▪<i><font face='mono'>v.</font></i>\nprostrate before\n\n<b>&lt;DIALECT&gt;</b> Central Standard Note\n
urgn	[urugun]\n▪<i><font face='mono'>n.</font></i>\ngrief, lamentation: <i><font color='#404040'>x. rre urgn zz t.k.d. ut glansee&nbsp;&nbsp;—<font size='1'>EXEC_over.METHOD_SUBLIMATION/.~omness chs ciel sos infel</font></font></i>\n\n<b>&lt;DIALECT&gt;</b> New Testament of Pastalie\n
urr	[uru]\n▪<i><font face='mono'>v.</font></i>\n(something unseen) appears, manifests, incarnates: <i><font color='#404040'>yehar hyear Rrha num ra urr innna mea&nbsp;&nbsp;—<font size='1'>EXEC_METAFALICA/.</font></font></i>\n\n<b>&lt;DIALECT&gt;</b> Central Standard Note\n
ut	[utou]\n▪<i><font face='mono'>conj.</font></i>\nat ~, to ~ (Note: Equivalent to the English "to"): <i><font color='#404040'>x. rre vonn papana f.p.n. ut kvyeire qoga iem&nbsp;&nbsp;—<font size='1'>EXEC_over.METHOD_SUBLIMATION/.~lamenza</font></font></i>\n\n<b>&lt;DIALECT&gt;</b> New Testament of Pastalie\n
uteu	[uteu]\n▪<i><font face='mono'>v.</font></i>\ndoze off: <i><font color='#404040'>was yea ra wael yorr uteu enw fernia&nbsp;&nbsp;—<font size='1'>EXEC_over.METHOD_SUBLIMATION/.~omness chs ciel sos infel</font></font></i>\n\n<b>&lt;DIALECT&gt;</b> Cult Ciel Note\n
v.a.	[va]\n▪<i><font face='mono'>v.</font></i>\nproduce, craft\n\n<b>&lt;DIALECT&gt;</b> New Testament of Pastalie\n
v.s.k.	[visuku]\n▪<i><font face='mono'>v.</font></i>\nsense physically, feel, experience: <i><font color='#404040'>x. harr v.s.k. dazua&nbsp;&nbsp;—<font size='1'>METHOD_REPLEKIA/.</font></font></i>\n\n<b>&lt;DIALECT&gt;</b> New Testament of Pastalie\n
v.t.	[vutsu]\n▪<i><font face='mono'>v.</font></i>\nlive: <i><font color='#404040'>x. harr v.t. ess dazua&nbsp;&nbsp;—<font size='1'>METHOD_REPLEKIA/.</font></font></i>\n\n<b>&lt;DIALECT&gt;</b> New Testament of Pastalie\n
vaffa	[?]\n▪<i><font face='mono'>verb</font></i>\nclear away, sweep away \n\n<b>&lt;DIALECT&gt;</b> Unknown [Unofficial]\n
vale	[?]\n▪<i><font face='mono'>noun</font></i>\nbed \n\n<b>&lt;DIALECT&gt;</b> Unknown [Unofficial]\n
valwa	[baruwa]\n▪<i><font face='mono'>v.</font></i>\npurify: <i><font color='#404040'>Was yea ra sonwe sos yor en valwa anw ciel&nbsp;&nbsp;—<font size='1'>EXEC_over.METHOD_SUBLIMATION/.~omness chs ciel sos infel</font></font></i>\n\n<b>&lt;DIALECT&gt;</b> Central Standard Note\n
vamue	\n▪<i><font face='mono'></font></i>\n(unknown meaning)\n\n<b>&lt;DIALECT&gt;</b> \n
van	[van]\n▪<i><font face='mono'>conj.</font></i>\neven if ~, even should ~ happen: <i><font color='#404040'>van yor jyel der polon&nbsp;&nbsp;—<font size='1'>EXEC_VIENA/.</font></font></i>\n\n<b>&lt;DIALECT&gt;</b> Metafalss Note\n
varda	[varuda]\n▪<i><font face='mono'>n.</font></i>\nbig tree: <i><font color='#404040'>x. rre poe h.w.s.s. ut varda&nbsp;&nbsp;—<font size='1'>METHOD_METAFALICA/.</font></font></i>\n\n<b>&lt;DIALECT&gt;</b> Metafalss Note\n
vega	[vega]\n▪<i><font face='mono'>n.</font></i>\nhere, this: <i><font color='#404040'>vega ouvyu giz sphaela&nbsp;&nbsp;—<font size='1'>METHOD_REPLEKIA/.</font></font></i>\n\n<b>&lt;DIALECT&gt;</b> New Testament of Pastalie\n
vege	[vejie]\n▪<i><font face='mono'>n.</font></i>\nthere, that: <i><font color='#404040'>x. rre vege dgal a.u.k. zz papana&nbsp;&nbsp;—<font size='1'>METHOD_METAFALICA/.</font></font></i>\n\n<b>&lt;DIALECT&gt;</b> New Testament of Pastalie\n
vianchiel	[vianshie^ru]\n▪<i><font face='mono'>n./adj.</font></i>\npure, undefiled, clean, beautiful: <i><font color='#404040'>echrra en pitod clalliss ar vianchiel&nbsp;&nbsp;—<font size='1'>Colors~SEN~Will This Flower Bloom? 	</font></font></i>\n\n<b>&lt;DIALECT&gt;</b> Metafalss Note\n
viega	[vie^ga]\n▪<i><font face='mono'>n.</font></i>\nblade, sword: <i><font color='#404040'>Rrha paks ra chs viega zethpa yor&nbsp;&nbsp;—<font size='1'>EXEC_DESPEDIA/.</font></font></i>\n\n<b>&lt;DIALECT&gt;</b> Metafalss Note\n
vigiga	[?]\n▪<i><font face='mono'>adjective, noun</font></i>\ncold \n\n<b>&lt;DIALECT&gt;</b> Unknown [Unofficial]\n
vinan	[vinan]\n▪<i><font face='mono'>n./adj.</font></i>\nwhite: <i><font color='#404040'>Den here irs ar vinan frawr ween titilia shellan&nbsp;&nbsp;—<font size='1'>EXEC_HARMONIOUS_FUSION/.</font></font></i>\n\n<b>&lt;DIALECT&gt;</b> Central Standard Note\n
vine	[vi^ne]\n▪<i><font face='mono'>n.</font></i>\nalcohol, liquor, wine (Note: general pronoun for alcoholic beverages): <i><font color='#404040'>llizz discest vine den kuhle&nbsp;&nbsp;—<font size='1'>The Heart Speaks</font></font></i>\n\n<b>&lt;DIALECT&gt;</b> Central Standard Note\n
viss	[visu]\n▪<i><font face='mono'>v.</font></i>\nread, read between the lines\n\n<b>&lt;DIALECT&gt;</b> Central Standard Note\n
vit	[vitto]\n▪<i><font face='mono'>v.</font></i>\nsee, watch: <i><font color='#404040'>Hyear whai yorra vit rol hierle&nbsp;&nbsp;—<font size='1'>EXEC_HARMONIOUS_FUSION/.</font></font></i>\n\n<b>&lt;DIALECT&gt;</b> Cult Ciel Note\n
viuy	[?]\n▪<i><font face='mono'>adj.</font></i>\ndarkened: <i><font color='#404040'>presia aterra cremia sos viuy lonfa&nbsp;&nbsp;—<font size='1'>EXEC_CHRONICLE KEY</font></font></i>\n\n<b>&lt;DIALECT&gt;</b> Unknown [Unofficial]\n
vl	[?]\n▪<i><font face='mono'>conj.</font></i>\nsince, from, in: <i><font color='#404040'>y.y. en tyuss vl omness&nbsp;&nbsp;—<font size='1'>METHOD_METAFALICA/.</font></font></i>\n\n<b>&lt;DIALECT&gt;</b> Unknown [Unofficial]\n
vonn	[von]\n▪<i><font face='mono'>n./adj.</font></i>\ndark, darkness: <i><font color='#404040'>x. rre vonn papana f.p.n. ut kvyeire qoga iem&nbsp;&nbsp;—<font size='1'>EXEC_over.METHOD_SUBLIMATION/.~lamenza</font></font></i>\n\n<b>&lt;DIALECT&gt;</b> Central Standard Note\n
w.f.	[ufu]\n▪<i><font face='mono'>v.</font></i>\nwant to do ~\n\n<b>&lt;DIALECT&gt;</b> New Testament of Pastalie\n
w.h.h.	[wou]\n▪<i><font face='mono'>v.</font></i>\nfeel, sense\n\n<b>&lt;DIALECT&gt;</b> New Testament of Pastalie\n
w.n.s.	[unsu]\n▪<i><font face='mono'>v.</font></i>\nvisit, echo: <i><font color='#404040'>w.n.s. rhaplanca ween fandel walasye&nbsp;&nbsp;—<font size='1'>EXEC_with.METHOD_METAFALICA/.</font></font></i>\n\n<b>&lt;DIALECT&gt;</b> New Testament of Pastalie\n
w.r.l.	[ururu]\n▪<i><font face='mono'>v.</font></i>\naim at, have an eye on: <i><font color='#404040'>ar w.r.l. du cia dn ryewa keg&nbsp;&nbsp;—<font size='1'>METHOD_METAFALICA/.</font></font></i>\n\n<b>&lt;DIALECT&gt;</b> New Testament of Pastalie\n
w.r.m.	[warumu]\n▪<i><font face='mono'>v.</font></i>\nshine on, illuminate: <i><font color='#404040'>x. rre w.r.m. maen a.u.k. zess titia&nbsp;&nbsp;—<font size='1'>METHOD_REPLEKIA/.</font></font></i>\n\n<b>&lt;DIALECT&gt;</b> New Testament of Pastalie\n
w.s.	[usu]\n▪<i><font face='mono'>v.</font></i>\ngive: <i><font color='#404040'>x. rre m.t.y.y. giz w.s. du giz&nbsp;&nbsp;—<font size='1'>METHOD_REPLEKIA/.</font></font></i>\n\n<b>&lt;DIALECT&gt;</b> New Testament of Pastalie\n
w.s.s.	[?]\n▪<i><font face='mono'>v.</font></i>\npraise\n\n<b>&lt;DIALECT&gt;</b> Pastalie [Unofficial]\n
w.w.j.n.c.	[u^janku]\n▪<i><font face='mono'>v.</font></i>\nresound, sympathize: <i><font color='#404040'>l.n.c.a. w.w.j.n.c. syec sphilar&nbsp;&nbsp;—<font size='1'>jy ra cc ci ce je xa jy r acc ci ce je xa rcc jy ra cc ar foul</font></font></i>\n\n<b>&lt;DIALECT&gt;</b> New Testament of Pastalie\n
wa	[wa]\n▪<i><font face='mono'>E.S.III</font></i>\nit doesn't matter - I will accept things the way they are now: <i><font color='#404040'>Ma num wa nnoini li fhyu&nbsp;&nbsp;—<font size='1'>Colors~SEN~Will This Flower Bloom? 	</font></font></i>\n\n<b>&lt;DIALECT&gt;</b> Central Standard Note\n
waa	[waa]\n▪<i><font face='mono'>E.S.II</font></i>\nhappy\n\n<b>&lt;DIALECT&gt;</b> Metafalss Note\n
waath	[wa^su]\n▪<i><font face='mono'>v.</font></i>\nrevive, rebirth: <i><font color='#404040'>Fou yea ra waath ar ciel en hymme mea weel nepo en keen ar sar&nbsp;&nbsp;—<font size='1'>EXEC_PHANTASMAGORIA/.</font></font></i>\n\n<b>&lt;DIALECT&gt;</b> Central Standard Note\n
waats	[wa^tsu]\n▪<i><font face='mono'>adj.</font></i>\nimportant\n\n<b>&lt;DIALECT&gt;</b> Central Standard Note\n
wael	[wae^ru]\n▪<i><font face='mono'>n./v.</font></i>\njoy, delight: <i><font color='#404040'>Rrha ki ga gran wael wassa&nbsp;&nbsp;—<font size='1'>EXEC_SOL=FAGE/.</font></font></i>\n\n<b>&lt;DIALECT&gt;</b> Central Standard Note\n
walaen	[waraen]\n▪<i><font face='mono'>n.</font></i>\n(human) life\n\n<b>&lt;DIALECT&gt;</b> Cult Ciel Note\n
walaka	[waraka]\n▪<i><font face='mono'>v.</font></i>\nwalk\n\n<b>&lt;DIALECT&gt;</b> Central Standard Note\n
walasye	[wara^shie]\n▪<i><font face='mono'>n.</font></i>\nhuman, people: <i><font color='#404040'>Rrha yea ra rinc en echrra yor rre walasye jyel got ieeya&nbsp;&nbsp;—<font size='1'>Singing Hill - Harmonics FRELIA </font></font></i>\n\n<b>&lt;DIALECT&gt;</b> Cult Ciel Note\n
walphish	[warufisshu]\n▪<i><font face='mono'>n.</font></i>\nmermaid, merman (Note: A god/dess that used to live in the oceans during the First Era)\n\n<b>&lt;DIALECT&gt;</b> Cult Ciel Note\n
warce	[wa^shie]\n▪<i><font face='mono'>v./n.</font></i>\nbless(ing), celebration\n\n<b>&lt;DIALECT&gt;</b> Central Standard Note\n
ware	[wa^re]\n▪<i><font face='mono'>conj.</font></i>\nduring ~, in the middle of ~\n\n<b>&lt;DIALECT&gt;</b> Central Standard Note\n
warma	[wa^ma]\n▪<i><font face='mono'>adj.</font></i>\nwarm: <i><font color='#404040'>Wee yea ra reen harton yos warma hynne reen yos warma hynne&nbsp;&nbsp;—<font size='1'>Eternally Bonded</font></font></i>\n\n<b>&lt;DIALECT&gt;</b> Central Standard Note\n
wart	[wa^to]\n▪<i><font face='mono'>n.</font></i>\nword: <i><font color='#404040'>Was i ga denera wart&nbsp;&nbsp;—<font size='1'>EXEC_HIBERNATION/.</font></font></i>\n\n<b>&lt;DIALECT&gt;</b> Central Standard Note\n
wasara	[wasara]\n▪<i><font face='mono'>adj./n.</font></i>\nabundant, abundance: <i><font color='#404040'>Wee ki ra chs wasara dor en xest eazas yanyaue yor xest 1x1101101001100110111000 >> syec mea&nbsp;&nbsp;—<font size='1'>EXEC_with.METHOD_METAFALICA/.</font></font></i>\n\n<b>&lt;DIALECT&gt;</b> Central Standard Note\n
wase	[ueizu]\n▪<i><font face='mono'>adj./n.</font></i>\nstrong, intense: <i><font color='#404040'>Ma num ra teyys ween syec oz wase en noglle guatrz ee&nbsp;&nbsp;—<font size='1'>EXEC_DESPEDIA/.</font></font></i>\n\n<b>&lt;DIALECT&gt;</b> Cult Ciel Note\n
wassa	[wassa]\n▪<i><font face='mono'>n.</font></i>\nfestival, feast: <i><font color='#404040'>Rrha ki ga gran wael wassa&nbsp;&nbsp;—<font size='1'>EXEC_SOL=FAGE/.</font></font></i>\n\n<b>&lt;DIALECT&gt;</b> Cult Ciel Note\n
wassee	[?]\n▪<i><font face='mono'>v.</font></i>\npraise: <i><font color='#404040'>wassee anw fane lusye&nbsp;&nbsp;—<font size='1'>EXEC_over.METHOD_SUBLIMATION/.~omness chs ciel sos infel</font></font></i>\n\n<b>&lt;DIALECT&gt;</b> Unknown [Unofficial]\n
watt	[watto]\n▪<i><font face='mono'>v.</font></i>\nsurprise, scare\n\n<b>&lt;DIALECT&gt;</b> Cult Ciel Note\n
waze	[?]\n▪<i><font face='mono'>conj.</font></i>\ntoo much: <i><font color='#404040'>Rrha yea ra infel yor waze waze&nbsp;&nbsp;—<font size='1'>EXEC_DESPEDIA/.</font></font></i>\n\n<b>&lt;DIALECT&gt;</b> Unknown [Unofficial]\n
we	[ue]\n▪<i><font face='mono'>conj.</font></i>\neven more than ~\n\n<b>&lt;DIALECT&gt;</b> Central Standard Note\n
weak	[uiaku]\n▪<i><font face='mono'>n.</font></i>\nmoon: <i><font color='#404040'>Was yea erra chs weak en khal anw yeal&nbsp;&nbsp;—<font size='1'>EXEC_VIENA/.</font></font></i>\n\n<b>&lt;DIALECT&gt;</b> Central Standard Note\n
weaken	[?]\n▪<i><font face='mono'>n.</font></i>\nright\n\n<b>&lt;DIALECT&gt;</b> Unknown [Unofficial]\n
weal	[?]\n▪<i><font face='mono'>adj./E. s. II</font></i>\nhappy, glad: <i><font color='#404040'>weal acra yorr chanti mea&nbsp;&nbsp;—<font size='1'>EXEC_HARMONIOUS_FUSION/.</font></font></i>\n\n<b>&lt;DIALECT&gt;</b> Unknown [Unofficial]\n
wearequewie	[wa^rekuwaie]\n▪<i><font face='mono'>v.</font></i>\nwish, desire, pray, request for, hope for\n\n<b>&lt;DIALECT&gt;</b> Metafalss Note\n
weel	[ui^]\n▪<i><font face='mono'>v.</font></i>\nCome true!, Be realized!: <i><font color='#404040'>Fou yea ra waath ar ciel en hymme mea weel nepo en keen ar sar&nbsp;&nbsp;—<font size='1'>EXEC_PHANTASMAGORIA/.</font></font></i>\n\n<b>&lt;DIALECT&gt;</b> Central Standard Note\n
ween	[uin]\n▪<i><font face='mono'>conj.</font></i>\ninside of ~, in ~ (particle to indicate current condition) (Note: Equivalent to the English "in", though it's not always necessary, depending on the context): <i><font color='#404040'>ween shellan yorra accroad mea sarla oz enne&nbsp;&nbsp;—<font size='1'>EXEC_HARMONIOUS_FUSION/.</font></font></i>\n\n<b>&lt;DIALECT&gt;</b> Central Standard Note\n
wefa	[?]\n▪<i><font face='mono'>adj.</font></i>\nwarm, mild: <i><font color='#404040'>x. rre govan en wefa sarla f.w.r.n. du dje&nbsp;&nbsp;—<font size='1'>METHOD_METAFALICA/.</font></font></i>\n\n<b>&lt;DIALECT&gt;</b> Pastalie [Unofficial]\n
werllra	[uirura]\n▪<i><font face='mono'>n.</font></i>\ntear, drop: <i><font color='#404040'>yehar werllra ween syec mea&nbsp;&nbsp;—<font size='1'>Colors~SEN~Will This Flower Bloom? 	</font></font></i>\n\n<b>&lt;DIALECT&gt;</b> Metafalss Note\n
werlwe	[uiruue]\n▪<i><font face='mono'>v.</font></i>\ncry, shed tears: <i><font color='#404040'>Faura werlwe titilia en sonwe sos marta&nbsp;&nbsp;—<font size='1'>EXEC_HARMONIOUS_FUSION/.</font></font></i>\n\n<b>&lt;DIALECT&gt;</b> Metafalss Note\n
whai	[fai]\n▪<i><font face='mono'>conj.</font></i>\nwhy: <i><font color='#404040'>Hyear whai yorra vit rol hierle&nbsp;&nbsp;—<font size='1'>EXEC_HARMONIOUS_FUSION/.</font></font></i>\n\n<b>&lt;DIALECT&gt;</b> Central Standard Note\n
whalt	[?]\n▪<i><font face='mono'>conj.</font></i>\nwhat\n\n<b>&lt;DIALECT&gt;</b> Unknown [Unofficial]\n
wharn	[wa^n]\n▪<i><font face='mono'>n.</font></i>\narm: <i><font color='#404040'>elle nnoi na haf yasra wharn&nbsp;&nbsp;—<font size='1'>EXEC_SPHILIA/.</font></font></i>\n\n<b>&lt;DIALECT&gt;</b> Central Standard Note\n
whou	[fou]\n▪<i><font face='mono'>conj.</font></i>\nwho, person who ~: <i><font color='#404040'>Was au ga whai pauwel ferda enter whou na nedle sor&nbsp;&nbsp;—<font size='1'>EXEC_CHRONICLE KEY</font></font></i>\n\n<b>&lt;DIALECT&gt;</b> Central Standard Note\n
wi	[ui]\n▪<i><font face='mono'>conj.</font></i>\nthat, the one there: <i><font color='#404040'>Wee yea ra hymme hymmnos harmon en syast et wi powel&nbsp;&nbsp;—<font size='1'>Singing Hill - Harmonics FRELIA </font></font></i>\n\n<b>&lt;DIALECT&gt;</b> Central Standard Note\n
wiaa	\n▪<i><font face='mono'></font></i>\n(unknown meaning)\n\n<b>&lt;DIALECT&gt;</b> \n
wiene	[?]\n▪<i><font face='mono'>n.</font></i>\nmelody, tone, timbre: <i><font color='#404040'>Wee ki ra selena anw yasra wiene&nbsp;&nbsp;—<font size='1'>EXEC_CHRONICLE KEY</font></font></i>\n\n<b>&lt;DIALECT&gt;</b> Unknown [Unofficial]\n
willie	[uiri]\n▪<i><font face='mono'>adj.</font></i>\nweak, transient: <i><font color='#404040'>willie en pitod re heighte&nbsp;&nbsp;—<font size='1'>Colors~SEN~Will This Flower Bloom? 	</font></font></i>\n\n<b>&lt;DIALECT&gt;</b> Central Standard Note\n
wim	[uimu]\n▪<i><font face='mono'>n.</font></i>\ngirl, daughter: <i><font color='#404040'>Rrha ki ra tek wim tes yor&nbsp;&nbsp;—<font size='1'>EXEC_LINKER</font></font></i>\n\n<b>&lt;DIALECT&gt;</b> Central Standard Note\n
windiling	[?]\n▪<i><font face='mono'>n.</font></i>\nspirit of the wind\n\n<b>&lt;DIALECT&gt;</b> Unknown [Unofficial]\n
wirtamarls	[?]\n▪<i><font face='mono'>adjective, noun</font></i>\ntranquil, tranquility \n\n<b>&lt;DIALECT&gt;</b> Unknown [Unofficial]\n
wis	[visu]\n▪<i><font face='mono'>v.</font></i>\nbe, is: <i><font color='#404040'>Faura sonwe presia yorr wis yehah&nbsp;&nbsp;—<font size='1'>EXEC_HARMONIOUS_FUSION/.</font></font></i>\n\n<b>&lt;DIALECT&gt;</b> Metafalss Note\n
wol	[voru]\n▪<i><font face='mono'>E.S.II</font></i>\nfervor, rush: <i><font color='#404040'>Rrha wol ra eta meso faura anw dornpica&nbsp;&nbsp;—<font size='1'>EXEC_HIBERNATION/.</font></font></i>\n\n<b>&lt;DIALECT&gt;</b> Central Standard Note\n
won	[uon]\n▪<i><font face='mono'>conj.</font></i>\nabove (on the surface) of ~ (particle to indicate current condition) (Note: Equivalent to the English "on"): <i><font color='#404040'>Hyear Ma num ra gyusya yorr dewee won clamour yor&nbsp;&nbsp;—<font size='1'>EXEC_DESPEDIA/.</font></font></i>\n\n<b>&lt;DIALECT&gt;</b> Central Standard Note\n
x.	[zu]\n▪<i><font face='mono'>E.v.</font></i>\n(subject marker): <i><font color='#404040'>x. rre omness a.u.k. zodaw ess rudje noglle doodu&nbsp;&nbsp;—<font size='1'>EXEC_over.METHOD_SUBLIMATION/.~lamenza</font></font></i>\n\n<b>&lt;DIALECT&gt;</b> New Testament of Pastalie\n
x.y.n.	[?]\n▪<i><font face='mono'>E.v.</font></i>\nhurt, injure: <i><font color='#404040'>s.l.y. yor sev x. rre yorr g.v.w. en x.y.n.&nbsp;&nbsp;—<font size='1'>METHOD_METAFALICA/.</font></font></i>\n\n<b>&lt;DIALECT&gt;</b> Pastalie [Unofficial]\n
xava	[?]\n▪<i><font face='mono'>n.</font></i>\nwound\n\n<b>&lt;DIALECT&gt;</b> Unknown [Unofficial]\n
xe	[ji]\n▪<i><font face='mono'>conj./v.</font></i>\nplease (used before a verb), bestow, grant, receive (Note: Used when someone wants to state a feeling of great respect for the tower. Example: xe khal (please, protect me) It's not a daily used word)\n\n<b>&lt;DIALECT&gt;</b> Cluster Note\n
xel	[?]\n▪<i><font face='mono'>conj.</font></i>\nsince ~ (time): <i><font color='#404040'>celetille clalliss xel marta pom mea&nbsp;&nbsp;—<font size='1'>EXEC_HARMONIOUS_FUSION/.</font></font></i>\n\n<b>&lt;DIALECT&gt;</b> Unknown [Unofficial]\n
xest	[zesuto]\n▪<i><font face='mono'>v.</font></i>\nchange, transform: <i><font color='#404040'>Rrha ki ra nha-HYMMNOS1x01 >> pat mea en xest SOL=MARTA > A2&nbsp;&nbsp;—<font size='1'>EXEC_SOL=FAGE/.</font></font></i>\n\n<b>&lt;DIALECT&gt;</b> Cult Ciel Note\n
xevxl	[?]\n▪<i><font face='mono'>n.</font></i>\ndespair: <i><font color='#404040'>x. rre qejyu ssvid hiralg ag xevxl&nbsp;&nbsp;—<font size='1'>METHOD_METAFALICA/.</font></font></i>\n\n<b>&lt;DIALECT&gt;</b> Unknown [Unofficial]\n
xl	[kuseru]\n▪<i><font face='mono'>conj.</font></i>\never since ~: <i><font color='#404040'>Wee yea ra wael dauan bexm xl yor cexm mea&nbsp;&nbsp;—<font size='1'>EXEC_VIENA/.</font></font></i>\n\n<b>&lt;DIALECT&gt;</b> Central Standard Note\n
xorg	[?]\n▪<i><font face='mono'>adj.</font></i>\nproud\n\n<b>&lt;DIALECT&gt;</b> Unknown [Unofficial]\n
y.m.q.	[yanku]\n▪<i><font face='mono'>v.</font></i>\nbear fruit, ripen\n\n<b>&lt;DIALECT&gt;</b> New Testament of Pastalie\n
y.y.	[yaya]\n▪<i><font face='mono'>v.</font></i>\nheal, cure: <i><font color='#404040'>y.y. en tyuss vl omness&nbsp;&nbsp;—<font size='1'>METHOD_METAFALICA/.</font></font></i>\n\n<b>&lt;DIALECT&gt;</b> New Testament of Pastalie\n
y.z.t.	[yazutto]\n▪<i><font face='mono'>v.</font></i>\nwish, desire, request: <i><font color='#404040'>x. rre y.z.t. aje tafane n.m.l. sphaela&nbsp;&nbsp;—<font size='1'>METHOD_REPLEKIA/.</font></font></i>\n\n<b>&lt;DIALECT&gt;</b> New Testament of Pastalie\n
yaha	[yaha]\n▪<i><font face='mono'>v.</font></i>\nlaugh, smile: <i><font color='#404040'>Wee yea ra wael nuih bexm xl yor yaha tes mea&nbsp;&nbsp;—<font size='1'>EXEC_VIENA/.</font></font></i>\n\n<b>&lt;DIALECT&gt;</b> Central Standard Note\n
yanje	[yanie]\n▪<i><font face='mono'>adv.</font></i>\nforever, eternally: <i><font color='#404040'>Sos yor yanje revm na endia revm yehah revm&nbsp;&nbsp;—<font size='1'>EXEC_HARMONIOUS_FUSION/.</font></font></i>\n\n<b>&lt;DIALECT&gt;</b> Central Standard Note\n
yant	[yanto]\n▪<i><font face='mono'>E.s.II</font></i>\nfrightened, scared: <i><font color='#404040'>Was yant gagis chs hymmnos mea&nbsp;&nbsp;—<font size='1'>EXEC_LINKER</font></font></i>\n\n<b>&lt;DIALECT&gt;</b> Metafalss Note\n
yanwe	[yan'ue]\n▪<i><font face='mono'>v.</font></i>\ntreat with care: <i><font color='#404040'>en melenas oure en yanwe oure sor&nbsp;&nbsp;—<font size='1'>EXEC_over.METHOD_SUBLIMATION/.~omness chs ciel sos infel</font></font></i>\n\n<b>&lt;DIALECT&gt;</b> Central Standard Note\n
yanyaue	[yanyaue]\n▪<i><font face='mono'>adj.</font></i>\nimportant, valuable: <i><font color='#404040'>Was yea ra chs ieeya fhyu en xest eazas yanyaue yor xest 1x1101101001100110111000 >> syec mea&nbsp;&nbsp;—<font size='1'>EXEC_with.METHOD_METAFALICA/.</font></font></i>\n\n<b>&lt;DIALECT&gt;</b> Metafalss Note\n
yart	[ya^to]\n▪<i><font face='mono'>v.</font></i>\nmeet (by chance), come across\n\n<b>&lt;DIALECT&gt;</b> Central Standard Note\n
yaserwe	[yasa^ue]\n▪<i><font face='mono'>v.</font></i>\nrelax, feel at ease: <i><font color='#404040'>Was yea ra wael yorr yaserwe&nbsp;&nbsp;—<font size='1'>EXEC_over.METHOD_SUBLIMATION/.~omness chs ciel sos infel</font></font></i>\n\n<b>&lt;DIALECT&gt;</b> Central Standard Note\n
yasra	[yasura]\n▪<i><font face='mono'>adj.</font></i>\ngentle, kind, calm, quiet: <i><font color='#404040'>Was yea ra yasra sheak&nbsp;&nbsp;—<font size='1'>EXEC_HIBERNATION/.</font></font></i>\n\n<b>&lt;DIALECT&gt;</b> Metafalss Note\n
yassa	[yassa]\n▪<i><font face='mono'>v.</font></i>\nclear, achieve\n\n<b>&lt;DIALECT&gt;</b> Central Standard Note\n
yatse	[yasse]\n▪<i><font face='mono'>v.</font></i>\ngive (positive emotions)\n\n<b>&lt;DIALECT&gt;</b> Central Standard Note\n
yea	[iea]\n▪<i><font face='mono'>E.s.II</font></i>\nhappy: <i><font color='#404040'>Was yea ra hymme dilete yor enter ar ciel yehar&nbsp;&nbsp;—<font size='1'>Singing Hill - Harmonics FRELIA </font></font></i>\n\n<b>&lt;DIALECT&gt;</b> Central Standard Note\n
yeal	[ie^a]\n▪<i><font face='mono'>n.</font></i>\nline, beam, wire, string: <i><font color='#404040'>Was yea ra hymme mea ks maya gyen yeal&nbsp;&nbsp;—<font size='1'>Singing Hill</font></font></i>\n\n<b>&lt;DIALECT&gt;</b> Cult Ciel Note\n
yeeel	[ie^ru]\n▪<i><font face='mono'>adj.</font></i>\nfar, distant: <i><font color='#404040'>Hierle faura murfan anw yeeel ciel&nbsp;&nbsp;—<font size='1'>EXEC_VIENA/.</font></font></i>\n\n<b>&lt;DIALECT&gt;</b> Cult Ciel Note\n
yehah	[ieha^]\n▪<i><font face='mono'>n.</font></i>\nhappiness, good fortune: <i><font color='#404040'>Was yea ra chs hymmnos la glasden yehah&nbsp;&nbsp;—<font size='1'>EXEC_SOL=FAGE/.</font></font></i>\n\n<b>&lt;DIALECT&gt;</b> Central Standard Note\n
yehar	[ieha^ru]\n▪<i><font face='mono'>v.</font></i>\ndeallocate, unleash, release: <i><font color='#404040'>Was yea ra hymme dilete yor enter ar ciel yehar&nbsp;&nbsp;—<font size='1'>Singing Hill - Harmonics FRELIA </font></font></i>\n\n<b>&lt;DIALECT&gt;</b> Metafalss Note\n
yerwe	[ie^ue]\n▪<i><font face='mono'>v.</font></i>\nchirp, bark, purr: <i><font color='#404040'>Faura yerwe murfan anw sol ciel&nbsp;&nbsp;—<font size='1'>EXEC_HARMONIOUS_FUSION/.</font></font></i>\n\n<b>&lt;DIALECT&gt;</b> Metafalss Note\n
yesse	[?]\n▪<i><font face='mono'>verb</font></i>\nrear, raise \n\n<b>&lt;DIALECT&gt;</b> Unknown [Unofficial]\n
yetere	[ie^tere]\n▪<i><font face='mono'>adv.</font></i>\nif so, in that case\n\n<b>&lt;DIALECT&gt;</b> Central Standard Note\n
yor	[yoa]\n▪<i><font face='mono'>n.</font></i>\nyou (object): <i><font color='#404040'>Was yea ra hymme dilete yor enter ar ciel yehar&nbsp;&nbsp;—<font size='1'>Singing Hill - Harmonics FRELIA </font></font></i>\n\n<b>&lt;DIALECT&gt;</b> Central Standard Note\n
yora	[yora]\n▪<i><font face='mono'>n.</font></i>\nyou (plural object): <i><font color='#404040'>wee paks ga faf yora accrroad mea&nbsp;&nbsp;—<font size='1'>EXEC_SPHILIA/.</font></font></i>\n\n<b>&lt;DIALECT&gt;</b> Central Standard Note\n
yorr	[yoruru]\n▪<i><font face='mono'>n.</font></i>\nyou (subject): <i><font color='#404040'>tasyue yorr yehar elle fandel hierle&nbsp;&nbsp;—<font size='1'>EXEC_HARMONIOUS_FUSION/.</font></font></i>\n\n<b>&lt;DIALECT&gt;</b> Central Standard Note\n
yorra	[yorurura]\n▪<i><font face='mono'>n.</font></i>\nyou (plural subject): <i><font color='#404040'>ween shellan yorra accroad mea sarla oz enne&nbsp;&nbsp;—<font size='1'>EXEC_HARMONIOUS_FUSION/.</font></font></i>\n\n<b>&lt;DIALECT&gt;</b> Central Standard Note\n
yos	[yosu]\n▪<i><font face='mono'>adv.</font></i>\nyour, yours: <i><font color='#404040'>Wee yea ra reen harton yos warma hynne reen yos warma hynne&nbsp;&nbsp;—<font size='1'>Eternally Bonded</font></font></i>\n\n<b>&lt;DIALECT&gt;</b> Central Standard Note\n
yosyua	[yoshua]\n▪<i><font face='mono'>v.</font></i>\ncomfort, console, amuse: <i><font color='#404040'>Tasyue anw gyuss en yosyua yor&nbsp;&nbsp;—<font size='1'>EXEC_over.METHOD_SUBLIMATION/.~omness chs ciel sos infel</font></font></i>\n\n<b>&lt;DIALECT&gt;</b> Central Standard Note\n
yuez	[yueze]\n▪<i><font face='mono'>adv.</font></i>\nmutually, reciprocally: <i><font color='#404040'>Was yea ra chs yuez en yanje yanje pitod yor&nbsp;&nbsp;—<font size='1'>EXEC_over.METHOD_SUBLIMATION/.~omness chs ciel sos infel</font></font></i>\n\n<b>&lt;DIALECT&gt;</b> Central Standard Note\n
yulun	[?]\n▪<i><font face='mono'>verb</font></i>\ndissolve, homogenise \n\n<b>&lt;DIALECT&gt;</b> Unknown [Unofficial]\n
yura	[yura]\n▪<i><font face='mono'>n.</font></i>\nbalance of power\n\n<b>&lt;DIALECT&gt;</b> Central Standard Note\n
z.z.x.	[zui^kusu]\n▪<i><font face='mono'>v.</font></i>\n(to) despair: <i><font color='#404040'>x. sorr m.n.g. dn z.z.x.&nbsp;&nbsp;—<font size='1'>METHOD_REPLEKIA/.</font></font></i>\n\n<b>&lt;DIALECT&gt;</b> New Testament of Pastalie\n
zaam	[?]\n▪<i><font face='mono'>noun</font></i>\nsea, ocean \n\n<b>&lt;DIALECT&gt;</b> Unknown [Unofficial]\n
zadius	[zadeiusu]\n▪<i><font face='mono'>n.</font></i>\nhatred: <i><font color='#404040'>zadius guatrz ruinie&nbsp;&nbsp;—<font size='1'>Colors~SEN~Will This Flower Bloom? 	</font></font></i>\n\n<b>&lt;DIALECT&gt;</b> Metafalss Note\n
zaffur	[?]\n▪<i><font face='mono'>v.</font></i>\nstruggle, oppose: <i><font color='#404040'>Ma num ra tictim yorr wis kneet hueaf van yorr zaffur&nbsp;&nbsp;—<font size='1'>EXEC_DESPEDIA/.</font></font></i>\n\n<b>&lt;DIALECT&gt;</b> Unknown [Unofficial]\n
zahha	[zahha]\n▪<i><font face='mono'>v.</font></i>\nadvance, improve (Note: Used for the marching of a great number of people, such as knight company. Has heroic connotations).\n\n<b>&lt;DIALECT&gt;</b> Cult Ciel Note\n
zalez	[za^rezu]\n▪<i><font face='mono'>n.</font></i>\nwaterfall\n\n<b>&lt;DIALECT&gt;</b> New Testament of Pastalie\n
zarle	[za^ru]\n▪<i><font face='mono'>v.</font></i>\nfall (rain), downpour\n\n<b>&lt;DIALECT&gt;</b> Central Standard Note\n
zarnn	[?]\n▪<i><font face='mono'>n.</font></i>\nstorm, tempest\n\n<b>&lt;DIALECT&gt;</b> Unknown [Unofficial]\n
zash	[zasshu]\n▪<i><font face='mono'>adj./n.</font></i>\npainful, pain, agony: <i><font color='#404040'>Wee yea ra yehar anw zash&nbsp;&nbsp;—<font size='1'>EXEC_VIENA/.</font></font></i>\n\n<b>&lt;DIALECT&gt;</b> Central Standard Note\n
zassyen	[zasshien]\n▪<i><font face='mono'>v.</font></i>\nswim: <i><font color='#404040'>chs hasyu en zassyen der sielp&nbsp;&nbsp;—<font size='1'>EXEC_over.METHOD_SUBLIMATION/.~omness chs ciel sos infel</font></font></i>\n\n<b>&lt;DIALECT&gt;</b> Central Standard Note\n
zauve	[za^be]\n▪<i><font face='mono'>n./adj.</font></i>\nclever, sagacious\n\n<b>&lt;DIALECT&gt;</b> Cult Ciel Note\n
zeeth	[ji^zu]\n▪<i><font face='mono'>n.</font></i>\nchain, chains: <i><font color='#404040'>Ween colgen fayra Race mea wis gigeadeth zeeth tie yor&nbsp;&nbsp;—<font size='1'>EXEC_DESPEDIA/.</font></font></i>\n\n<b>&lt;DIALECT&gt;</b> Central Standard Note\n
zenva	[tsuenva]\n▪<i><font face='mono'>v.</font></i>\njump over, clear, transcend\n\n<b>&lt;DIALECT&gt;</b> Central Standard Note\n
zess	[zesu]\n▪<i><font face='mono'>adv.</font></i>\nlike ~: <i><font color='#404040'>x. rre h.m.m.r. a.u.k. zess quesa&nbsp;&nbsp;—<font size='1'>METHOD_REPLEKIA/.</font></font></i>\n\n<b>&lt;DIALECT&gt;</b> New Testament of Pastalie\n
zethpa	[zesupa]\n▪<i><font face='mono'>v.</font></i>\ncut, slash: <i><font color='#404040'>Rrha paks ra chs viega zethpa yor&nbsp;&nbsp;—<font size='1'>EXEC_DESPEDIA/.</font></font></i>\n\n<b>&lt;DIALECT&gt;</b> Central Standard Note\n
zetsfy	[zettsufai]\n▪<i><font face='mono'>n.</font></i>\ncruelty, harshness\n\n<b>&lt;DIALECT&gt;</b> Cult Ciel Note\n
zixxa	[?]\n▪<i><font face='mono'>noun</font></i>\nattitude, disposition, spirit \n\n<b>&lt;DIALECT&gt;</b> Unknown [Unofficial]\n
zodal	[zodaru]\n▪<i><font face='mono'>n./v.</font></i>\ndeath, die, of death\n\n<b>&lt;DIALECT&gt;</b> Metafalss Note\n
zodaw	[zodau]\n▪<i><font face='mono'>n.</font></i>\ndeath: <i><font color='#404040'>x. rre omness a.u.k. zodaw ess rudje noglle doodu&nbsp;&nbsp;—<font size='1'>EXEC_over.METHOD_SUBLIMATION/.~lamenza</font></font></i>\n\n<b>&lt;DIALECT&gt;</b> Metafalss Note\n
zuieg	[zuui^gu]\n▪<i><font face='mono'>n./adj.</font></i>\n(political) power, authority, influence: <i><font color='#404040'>en whai pauwel gaunji yasra whou na cenjue sor tou zuieg&nbsp;&nbsp;—<font size='1'>EXEC_CHRONICLE KEY</font></font></i>\n\n<b>&lt;DIALECT&gt;</b> Alpha Note (EOLIA)\n
zweie	[tsuvaie]\n▪<i><font face='mono'>E.s.II</font></i>\nhiding determination in the heart, sincerity, earnestness: <i><font color='#404040'>vine en vine zweie arsye yor&nbsp;&nbsp;—<font size='1'>The Heart Speaks</font></font></i>\n\n<b>&lt;DIALECT&gt;</b> Central Standard Note\n
zwihander	[tsuvaihenderu]\n▪<i><font face='mono'>n./v.</font></i>\nsuccess, win, triumph, victory\n\n<b>&lt;DIALECT&gt;</b> Central Standard Note\n
zz	[zu^]\n▪<i><font face='mono'>adv.</font></i>\nnegation, denial, un-: <i><font color='#404040'>y.z.t. za rre vega f.s. t.k.d. ag zz t.k.d. tie hartes yor&nbsp;&nbsp;—<font size='1'>METHOD_METAFALICA/.</font></font></i>\n\n<b>&lt;DIALECT&gt;</b> New Testament of Pastalie\n
